

soavam | Fantasiando | sacrifiquem | férrea | 
Esperem | sonhado | esperem | 
natural | chorando | esperes | inflama | 
palpitando | avarentos | 
entenda | férreo | companhias | manjarona | estregando | Gabelo | 
entende | Desses | mofina | desses | Entende | Esperá-lo | 
haverá | alparcas | sopeados | Haverá | 
deidades | Deidades | 
esperança | brancas | esparziu | entendo | tocou | Esperança | 
cabeceira | Gaditano | pecadores | roubará | ensinam | tiverdes | Ourique | 
sujeita | Melique | pescados | enganosos | Cisne | cisne | ensinar | Sujeita | Dizei-lhe | 
colher | mataram | Menon | mudarás | 
menos | despir | menor | Menos | Castelbranco | 
Gregos | ferozes | manhoso | estupro | Manhoso | Porteiro | 
sujeito | 
elegante | encheste | esperará | milícia | 
conquista | voava | Fazei | 
profeta | Profeta | Epicureia | 
fazem | Fazem | matarem | decem | Lustra | 
fazer | Fazer | Cipião | lustre | fazes | Fazes | 
marido | respeita | Cipro | Bispo | 
extrema | imigos | fazia | roubadoras | Cornélio | 
esperava | mente | quebranta | 
obriga | velhos | lassos | Bética | Falerno | Velhos | desparzidas | 
respeito | Neptuno | Eritreias | débil | esquadra | haviam | cristalinas | 
extremo | grandemente | armadas | espessa | Promete-lhos | Armadas | Grandemente | Francesa | 
ferros | milhor | cortada | 
obrigo | havida | 
todas | Todas | condenados | vodas | Bipur | voadores | roubadores | 
derrama | espesso | mercê | menina | 
tristes | amantes | cortado | 
aconselha | reformou | Gangética | 
esperta | misérias | 
futuro | mesas | menino | Mesas | santas | Jasque | Futuro | hospícios | Pede-lhe | julgavam | derramo | Menino | 
sonhadas | relíquias | Engolindo | Catigão | escusam | esforçadíssimo | 
águas | estavam | Itália | firmeza | escuras | mereça | Gangético | Estavam | chuças | Águas | desigual | cavalgam | Citas | escusar | 
batalhas | brancos | Batalhas | desque | Estavas | Heróstrato | lentas | 
aguda | escureça | 

ensinou | hórrida | Injuriada | costumadas | 
moradoras | meses | alongada | odres | mortandade | 
Nereu | aposento | sojugavam | agudo | severamente | Semirâmis | 
afugenta | começada | Trabucos | trabucos | Navarra | bebido | 
bondade | injuriado | escapar | deprava | Injuriado | Hispanos | moverdes | 
Cítia | choraram | Comecei | 
delgaçando | guiando | 
Comecem | cometerdes | devassando | começado | Navarro | terçados | 
nenhum | Nenhum | moradores | destas | festas | Destas | atravessando | 
desusada | 
Inglês | civis | esquecera | mudaste | 
repousasse | reformá-la | Faz-te | lançadas | 
maiores | entradas | desparzidos | Abrandar | 
cristalinos | 
armados | informar | 
destes | Destes | havendo | ferver | Havendo | Ítalos | cítaras | 
fulminantes | 
todos | Todos | mesma | tardança | esclarecidos | desvia | Mondar-se | recreasse | misilhões | 
brandas | Méroe | 
despede | notáveis | segunda | Despede | 
fértil | atrevimento | Noronha | Fértil | estudando | 
mesmo | subia | desvio | imprima | prenhes | merecem | 
cavaleiro | cortava | merecer | Cortava | longura | Vestida | queimadas | partíramos | 
segundo | naturais | resistência | Segundo | regedores | 
princesa | merecia | Escuros | Sabei | 
nesse | afagos | imperial | lentos | insolências | 
quais | Quais | subir | sabem | Vestido | vestido | Empíreo | rubis | assentam | Encosta-se | subis | Trabalhando | trabalhando | Subir | 
saber | Sofala | Saber | sabes | semeados | 
grita | repousavam | messo | detivesse | Costumados | Inspira | 
sabia | esparziam | Sabia | sábia | 
vencendo | Vencendo | Biscainha | 
nesta | Nesta | habita | Ciniras | Habita | Varrendo | mesta | regando | reluze | suspeitasse | suspeitar-se | 
neste | Neste | Mahometa | Levantam | grito | cavernoso | Começa-se | 
sábio | única | chuva | escapou | magnânimo | ociosos | 
namoradas | chegadas | retirar | escassa | estátua | compelia | 
hábito | Octávio | desonesta | 
despacho | Voando | voando | acostumados | discreta | fervor | despejo | 
único | Guzarates | 
conselho | Ródano | Conselho | escasso | começava | 
desonesto | Orando | rapace | orando | 
velhice | limada | unida | discreto | dourados | gastadores | RespondeuQual | 
metal | qualidade | Melindanos | 
encurvadas | prémios | vendido | Destro | Brâmene | aceita | destro | concertos | enterra | 
quase | Quase | diligentes | Parcas | sofreis | concertou | entendam | olímpica | 
úmido | quási | necessária | cadeias | férreos | Quási | unido | 
troncos | linces | Ambrósia | reprende | Troncos | militara | Porfiam | 
porfias | aceito | Pífaros | Dando-lhe | 
Atenas | avenas | opuseram | alçada | 
necessário | sabor | 
brandamente | entesta | chegassem | prometera | 
suave | corrupção | Suave | sacra | neves | pascer | Encélado | entendem | queimados | 
alçado | Entender | entender | 
negócio | traquetes | sórdido | sorrindo | vencemos | 
entendia | 
sacro | alaga | Pirítoo | Sacro | 
estranha | assentos | arrogantes | impérios | Estranha | 
lavada | assentou | 
Leucotoe | grémio | grêmio | Desbaratareis | 
Deixando | deixando | 
estranho | Albis | lograda | Sofrerá | Estranho | 
derriba | Derriba | navegados | 
excede | agreste | basiliscos | apelida | Basiliscos | 
chegados | Astúrias | namorados | levantou | Ausónía | desbaratadas | Chegados | Namorados | 
Portuguesas | frondente | Quedá | queda | 
asinha | cansados | surdos | 
Otomano | apelido | 
seguras | Saramá | 
quedo | despida | haveria | 
enobrecido | doutrina | perjúrios | puder | invenções | 
rodeia | 
Portugueses | populares | prometida | falta-lhe | furiosas | 
terríbil | feias | pilotos | netos | Tenassari | Ensina-lo | Pilotos | 
esperanças | Contando | restante | Vencerão | Feaces | 
condena | alevantam | Bramido | Vencerás | rodeio | 
Príncipe | prometido | Prometido | Cadeira | Ostras | sedento | podeis | alevantar | 
clara | gravíssimos | tornada | Tornada | trabalharem | 
adorando | Héroas | Alça-se | 
aspérrimos | Vencerei | 
porventura | Páfia | esperando | 
claro | Tornado | tornado | sessenta | fadado | 
histórias | deixamos | pureza | zunido | Deixamos | Histórias | guiasse | 
ensinara | Capitão-mor | Tremendo | 
venceria | Tângere | sendal | 
Olimpo | Ulisseia | pendão | aventurados | Hidalcão | 
assinala | Atenta | atenta | sofrido | Dar-te-ei | rendas | semear | alongo | recobrar | 
Taprobana | roubarem | passeios | 
celebrada | presteza | Polifemo | cisnes | 
guarda | Guarda | lindas | quadrupedante | exime | Caudinas | 
parece | Veloso | irmão | Parece | atento | referem | recíproco | guarde | ensinava | 
hão | rudos | luzentes | iam | Vandália | irmãs | rodeou | Hão | Irmãs | Ismar | Iam | 
penedo | celebrado | poderá | desbaratados | hás | abominoso | Poderá | Heróis | indignadas | heróis | pendem | sinceras | Desbaratados | 
Rodrigo | gostando | guardo | 
oferece | rendeu | corrupto | Bebendo | Iaz | bebendo | misturar | Corrupto | 
semeia | acudindo | pendia | belíssima | 
instrumento | seguros | hei | Etiópica | afamam | Hei | 
quero | horrenda | Quero | Íncolas | proferia | 
daquela | Daquela | antíguos | 
daquele | Daquele | tolhe | Pafos | guiavam | vingueis | Nabateias | 
furiosos | encerra | condição | sentenças | Condição | renovam | 
horrendo | remotas | touros | tangiam | ouvidos | feios | abstinência | Imaginai | Horrendo | 
Padre | padre | esperamos | deixaram | deixarão | destreza | acolhiam | Temperado | Abranches | 
praias | Semele | Nhaia | Andrómeda | Praias | Mazcate | proêmio | 
natureza | Natureza | amarelo | Tratá-los | Efire | Floresce | Gil | ocupados | Alfeu | provasses | tigres | imaginar | 
tornara | tornará | debate | enxergamos | alevantou | 
vitória | vencesse | Vitória | 
autoridade | acenda | ignota | Siracusa | Removem | 
acende | Partazanas | cintilantes | límpidas | 
tornando-se | 
feita | deita | geralmente | Vândalos | cornígera | Feita | imaginem | Deita | 
quebrantados | Tígris | Cristóvão | selvagens | ignoto | adversa | 
lealdade | tornava | lúcido | deixaria | Corvino | 
crises | 
feito | consente | Alcácer | abalroar | Consente | poderemos | escrevessem | 
Debaxo | saiba | debaxo | Goa | airoso | 
Sujeitos | celebrara | sujeitos | estarmos | Inúmeros | 
deixa | Atlante | Deixa | sujeitou | 
deixe | Ulisseus | ruido | ruído | 
saíam | Pagão | trabalhavam | delfins | trezeno | procelosa | 
pagar | indignados | supersticiosa | Ios | intonsa | 
piedade | deixo | Deixo | irosa | escurecem | Contarei | ferrugem | sepultada | 
grã | ira | delas | irá | cumprisse | Sagaz | Deveis | Irá | sagaz | ouvireis | enleve | 
celebrava | elegantes | esperarás | 
adversário | confina | remete | Remete | cegueira | contares | escurecia | malévolo | 
iroso | instante | sepultado | Enxergaram | Febeia | 
respostas | forjado | Dórcadas | contaria | volta | 
Canárias | 

deles | Deles | remotos | deleite | Indígetes | voavam | 
conquistar | Encomendado | encomendado | 
algodão | detença | tratando | Suceder-lhe-á | 
Átropos | 
ousadamente | folhas | acenos | 
Amiúdam-se | deixasse | 
Délio | Tomai | estatutos | ruína | pertinácia | gostaram | formigas | 
Mostrando-se | rotundo | medrosas | mostrando-se | Cloris | Delis | 
tomam | Tomam | pressupôs | Aleto | 
tomar | Carmânia | Tomar | Alcáçare | feliz | Feliz | púrpura | 
Cípria | volteam | 
iníqua | quantidade | sacrifícios | someteria | 
trabalha | Alexandre | Trabalha | triagas | armando | 
temendo | Temendo | Azenegues | 
Lusitanas | permanecem | enrouquecida | Crista | Cristã | adquirindo | robustos | Lustram | 
Alexandro | grevas | 
trabalho | floresta | arreceosos | Cassiopeia | Lacedemónios | Trabalho | parida | carniceiros | 
deteve | 
Cristo | alhea | 
raios | domésticas | Raios | 
murchada | prósperos | 
Delos | Sonhando | 
daquilo | deixavam | tanque | imitam | possível | 
Lusitânia | Lampetusa | Imitar | descreve | Lépido | 
Boêmios | monstro | 
Altamente | 
adarga | Contar-te | contar-te | 
quantas | Climene | raramente | Quantas | 
tredores | devias | permites | verdades | enxergar-se | 
maridos | ferocidade | pague | 
devida | trouxeram | considera | faltaram | conquistou | faltarão | 
veludo | Atamante | Espanhóis | 
Alija | Cafres | apresentaram | encarecidas | canoras | 
tantas | Tantas | conserva | Trudante | 
senhor | Senhor | devido | fétido | Penhor | detido | penhor | 
achamos | ordenação | venenos | caramujos | Achamos | 
permitiu | fechar | empregue | rigoroso | 
sustinha | trepavam | lançando | Lançando | Armam-se | 
tomou | árvores | entrando | Tomou | Entrando | vendo-se | Vendo-se | ordenada | 
mulheres | clima | Alcióneas | Landroal | 
Palas | pombinha | escrituras | 
navegam | 
Lusitanos | esperavam | aspereza | navegar | Navegar | ordenado | 
nace | Nace | habitando | quebrantar | quebrantas | 
profundas | trataram | 
saudosas | fábrica | mentia | fende | enxergavam | 
língua | nação | algoz | Sigue-me | bem-aventurado | 
limite | esteira | igualam | Domésticos | maçãs | 
queimando | Latina | 
nada | Traces | ministros | Nada | Ministros | tratarei | 
despois | Despois | perpétua | mentir | Meotis | 
hipocrisia | Martes | 
numerosos | aconteceu | Acroceráunios | Aconteceu | 
nado | fadiga | acesos | 
buscando | mães | Buscando | perpétuo | Turcos | Mães | competia | demanda | 
quantos | Quantos | acharam | acharão | ilustram | demande | Acharam | 
despojo | esquadrão | Esquadrão | venerar | ilustrar | acharás | Maia | 
algum | Algum | coluna | esquadras | Martim | 
navegando | Fénix | topar | 
província | navegações | 
ócio | intentos | acharei | sujos | Entramos | Maio | penetras | inventor | 
mais | Mais | tantos | Joane | Tantos | sequazes | Vínculo | vaporzinho | 
acharem | aberta | agasalhou | acerta | venéreo | 
palma | ilustres | Décimo | 
extremos | apresentasse | Décios | 
frechas | habitamos | vizinhança | 
aberto | exalta | acerto | ordenara | 
Dinheiros | Virgílios | exalte | 
claramente | 
corações | Escrevendo | 
demos | mana | Demos | iguarias | cultura | assinalada | salsa | 
cortadas | lisonjeiros | Franceses | navegou | 
densa | 
ordenava | apascentavam | Saudosos | saudosos | 
salso | assinalado | atentado | 
mãos | gestos | face | indinadas | reluzente | cometessem | horríssonas | 
presentes | buscamos | continente | Começando-se | Comendo | 
Salta | obra | salta | lavradas | Prometo-te | 
façam | Livrar-se | salve | livrar-se | havidas | 
passada | faças | faltavam | agudeza | lançaram | Passada | 
possantes | navegamos | Entraram | vencem | infamado | apontando | entraram | 
torna | vencer | Torna | dada | Dada | Vencer | dádiva | salvo | 
torne | socorrê-la | Palavra | venceu | chegamos | preceitos | palavra | Torne | 
passado | soberbas | bombas | Passado | tracto | Sunda | Soberbas | 
mata | estridentes | Maçuá | zelo | disforme | 
dado | fado | Ocidente | torno | Fado | ilustrou | cipariso | venturoso | livraste | 
grandeza | Aqueronte | deu-lha | 
desce | guerreira | achasse | temesse | Deu-lhe | Achar-se | 
vossa | mato | generosa | desbaratando | Rumes | temais | faia | espumantes | opróbrios | desci | torra | descuidada | Vossa | 
naus | torpe | torre | maus | penetrou | apressurada | Naus | Maus | 
cidades | navegante | deram | punha | Deram | Míncio | Cidades | entraria | desçam | 
Meca | feras | guerreiro | usadas | obsequente | eternas | santifique | 
vosso | generoso | descuidado | estimada | mercês | Vosso | futuras | concha | 
temerosas | vencidas | côncavas | dais | 
desde | Desde | Istro | julgue-o | ebúrnea | temer-te | 
fala | Fala | pancada | torva | 
exemplo | estimado | fale | 
dali | Ouvindo | Dali | obedecendo | ouvindo | deleitava | retorcida | 
néscio | Samnítico | ebúrneo | vilezas | 
falo | dilúvio | 
combates | abundante | navegaram | arrebatado | combater | ocupando | repousado | 
Neptuninas | curiosos | buscarei | Plínio | aguada | 
fama | medo | dama | Fama | chegaram | Granada | mancebos | Dama | Pancaia | Herculanas | 
Camarões | indinados | camarões | 
peregrina | produze | estimais | triunfa | 
nega | ferir | meia | consagrado | lavrador | feminina | total | 
dano | soberana | Dano | Gangéticas | 
passara | navegarem | Ocidentais | ocidentais | geolhos | endurecidos | ecos | 
tristeza | terceira | peregrino | Terceira | Erínis | florece | Ítaco | cavalgada | 
meio | fará | Fará | ódio | rumor | nego | dará | pranta | feminino | Dará | 
soberano | pretendes | Ofir | demasia | Recupera | 
soberbos | Ródope | Determinam | altíssima | desculpas | Desculpas | escreverão | determinam | blasfemando | Henriques | Alteradas | 
nela | terceiro | pretendia | Terceiro | escapados | bramando | Nela | determinas | Bramando | 
nele | pranto | matá-lo | Polidoro | espertar | 
almas | nuvens | passava | Minerva | Lionês | Almas | limões | 
conquistando | Cuidam | cuidam | Rifeios | Orfeio | 
dava | Determinei | cuidar | inocente | ardentíssimos | influía | estacada | sempiterna | 
panos | ramos | vingando | amainamos | Ramos | 
estende | firmar | consolar-te | frequentam | 
feros | usados | embaixador | Horizonte | Feros | horizonte | ouvimos | desbaratasses | retiniam | Enche-se | Eternos | 
futuros | meninos | cuidei | Sempiterno | sempiterno | gólfão | fato | 
vencidos | feroz | temerosos | Vencidos | côncavos | Dessa | passarinho | socorrido | 
desse | Regedor | manifestaram | caibam | Influiu | regedor | queimasse | 
Hemisfério | hemisfério | aventuraram | Sujeitando | cuides | 
Idololatra | Febe | 
ferro | ordena | Ordena | rústico | 
santa | Ninfas | Santa | hospício | ordene | mesa | floridas | frequentes | 
Febo | zeloso | Moçandão | pintariam | 
desta | Desta | lançavam | festa | buscasse | buscar-se | comeria | comece | ferva | 
deste | Enquanto | enquanto | Deste | ferve | entravam | cítara | achado | Vendem | 
santo | merece | tendes | Santo | ordens | sucessor | puras | vender | sucessos | Tendes | Puras | queimada | Nero | 
Começam | começam | viradas | molestava | 
cansada | acostumado | sustido | surda | 
diligente | meta | Itálico | traições | passeavam | Despanto | Meta | 
neve | chegasse | militar | habitavam | dêem | mete | palpitantes | Gangéticos | pasce | resguarda | 
aconselhou | votos | sofrem | jóias | 
regimento | interesse | cansado | sofrer | conselheiros | surdo | Campaspe | Interesse | Sofrer | Guarnecidos | Gotfredo | 
piloto | feia | Piloto | Abrantes | etérea | neto | sofreu | Etérea | ouvida | Estava-se | Deia | 
meus | belicosas | penoso | Poesia | rasas | poesia | parar | 
tínhamos | Etíopes | obedeceram | logram | Condes | 
mistura | lograr | surge | gravidade | Surge | 
remota | feio | Etiópia | touro | ouvido | Ouvido | etéreo | renova | 
floresça | 
mandados | robusta | Mandados | papel | Panteia | mover-vos | Cesáreos | 
dela | escurece | Encobrem | Arracão | Dela | celestes | campais | 
dele | Dele | remoto | empresas | buscavam | Pares | Heróicos | pares | Amostrando-se | Cuidou | cuidou | 
devem | Latona | detêm | ouvirem | 
Lusitana | Mercúrio | deter | robusto | deves | profligados | lusitana | 
Monçaide | agudas | concebem | Aventurar-me | 
verdade | devia | navegavam | Obedeceis | sometidas | 
medroso | veneno | lustrosas | 
Lusitano | largamente | navega | amarras | chegavam | Vestem-se | 
dormiram | ministro | 
achara | Igreja | pariu | torpemente | temerá | temporespondia | Sicília | achará | 
ilustre | Ilustre | Párseos | Babilónias | 
Prasso | ouvi-lo | Cloto | influxo | Demo | navego | meneando | mudarmos | aventurar-se | 
grandes | lavrada | Chamam-lhe | amoesta | Grandes | vizinhas | 
ilustro | sotopostos | destoutra | 
fera | eterna | usada | dera | embaixada | claríssimo | Claríssimo | Eterna | 
fere | vileza | vingaram | Fere | 
passam | animosos | criancinhas | admirados | idades | auspício | Vingarás | tardou | louvarei | Achava | sustém | achava | começos | Passam | 
passar | determina | minas | benquisto | Determina | começou | 
fero | usado | eterno | desbaratar-se | Usado | logoÓ | prepara | 
Ninfa | vozes | jogos | 
enxárcia | milagres | ouvir-me | afeiçoados | perigosas | 
Nilo | logra | determino | obedecerá | loira | passei | queimava | Queimava | 
flores | deve | belicosos | 
Veneza | devoto | amainassem | passem | Cometam | Pões-te | 
passa | Passa | tenhais | mina | passes | disseAs | Mina | cometas | 
prudência | passe | gazela | pubrica | loiro | encostados | Abaixam | estáveis | trago | devo | cometa | 
Deus | minha | Deusa | comete | alumiasse | Minha | alcançada | deusa | Alcançada | deus | 
tenham | omnipotente | obedecesse | Tenham | venham | lavram | Venham | 
fica | passo | caídas | venhas | tenhas | Nino | 
gloriosa | alcançam | Cibele | cometo | Alcançam | disseÓ | 
ninho | Alvares | alcançado | DeusaO | temida | Minho | abaixaram | alcançar | disser | 
cometer | Deusas | minhas | detrás | Nisa | parta | Mínias | costuma | Cometer | sujeitaria | 
parte | costume | trajo | Parte | aposentos | Ouviu-o | fico | desfazendo | Fico | cometeu | Trajo | agudos | estéril | Nise | 
dias | Egas | glorioso | cometia | abrasar-lhe | horrífica | parti | aposentou | 
temido | ouvir-te | acordam | ouviste | Citera | lustrosos | Obedeceste | 
usança | pasto | parto | Citere | Rapto | rapto | terrestre | 
várias | Várias | escutando | Varias | 
Bizâncio | achega | Lusíadas | horrífico | fiei | 
Deuses | humildade | fiel | Fiel | Sequeira | Tarifa | 
conheça | edificada | fido | cizânia | Conheça | 
sempre | Sempre | vizinhos | Sarracenos | Acidália | limpos | singular | Mateus | Limpos | alcançá-la | artifício | 
avizinha | abrasado | Possuireis | dissonante | Egeu | 
bandeiras | diga | trará | Gueos | Trará | 
afrontada | comido | Astreia | 
ficam | destruir | ervinhas | madeiros | 
passos | ficar | destruiu | 
digo | passou | obedecido | hórridos | saúde | Cícero | 
adversidade | lavrava | 
visitado | perigosos | 
embebidos | Orlando | sutis | 
comigo | Restituidor | nadando | Nadando | Comigo | 
sentidos | inconstantes | fiado | Fiado | 
gloriosas | Cítico | soberbamente | 
trato | distintamente | sujeitar-se | águias | Cipiões | 
ligeiro | matéria | dissera | confusa | vingar-te | Matéria | erguem | pratos | alcançara | alimpam | 
disseSe | Vaticinando | concedeu | macias | 
fina | dina | fraqueza | Semideuses | Dina | recolhendo | óleo | Fraqueza | ergueu | Ibero | Recolhendo | 
estreita | Silves | erguia | dostrinhos | particular | 
confuso | Confuso | impudico | Vasconcelos | 
Olha | olha | alcançou | Carmesi | ninhos | carmesi | bramavam | 
fino | presença | dino | benignidade | Quilmance | fabulosa | Dino | bonina | Louvavam | 
Estreito | fios | estreito | chagas | fins | cometera | nacido | Cometerá | Sigamos | alcançava | 
Levassem | entristecido | Suspeitas | esculturas | fiou | 
Paulo | dirá | olho | alvoroçada | Olho | Dirá | Nerine | guiar | 
vários | Vários | sentem | acordou | estiravam | pentem | embandeirar-se | 
orelha | costumam | delgada | altíssona | pastam | 

alvoroçado | sentia | Roupinho | 
altas | alvas | Diana | afeição | altar | Estêvão | fiança | 
estrelas | nenhuma | Estrelas | delgado | Guido | 
ajuda | dita | urdia | ofertas | 
devastando | ajude | piedosa | Dite | cantassem | 
sentir | partem | Partem | 
partes | costumes | Sentiu | guardada | 
ficou | dito | Temístoeles | eito | Ficou | Sardanapalo | 
partia | piedoso | resplandece | navios | enganas | Partia | 
regê-los | mantendo | fiquei | 
guardado | acumulam | 
escutaram | fiquem | crueldade | riquíssimos | recolhemos | Vociferando | 
Boreais | Manda-lhe | visitava | Guardafú | 
cortando | gloriosos | Cortando | informação | Informação | partir | 
partiu | enojosas | fixo | 
elas | prazer | Elas | desejadas | 
Inglesa | tomando-lhe | concertada | puxam | Tomando-lhe | 
trema | cessando | 
enxerga | treme | submetesse | fugace | Enxerga | Treme | 
aparece | Aparece | habitadores | Lavrando | 
temidos | informado | ouvistes | concertado | esquecerão | 
correndo | Correndo | santíssima | 
eles | Oriente | prática | Eles | 
a | A | à | üa | trance | Arquico | À | embraçado | prosseguia | experimentas | Zona | 
razão | Anfitrite | Lácteo | sazão | guardá-lo | animada | 
guiou | santíssimo | salgarão | Européias | Oriento | Secas | 
escapando | 
pastor | arrenegados | tranças | Nobá | 
aluno | heresias | 
altos | Altos | aquentava | lisonge | sucedessem | 
arraial | mandá-los | arruído | 
e | E | é | É | f | longa | treva | d | F | D | è | Capadoces | 
longe | apartado | pazes | Longe | aproveita | onças | Duzentos | moças | assoviando | Pazes | 
quaisquer | Santiago | nisso | naceram | Nisso | Quaisquer | 
noda | onipotente | Onipotente | guardará | 
onde | Onde | longo | Longo | lisonja | repreendam | desocupar | 
animais | enganos | Animais | Antarctico | Enganos | regendo | 
tratamento | festeja | enganou | pincel | Festeja | 
modo | tributo | quebrar-lhe | Jáquete | 
reais | fabricada | dalguns | percam | pequenas | Reais | Treze | 
nisto | Nisto | domada | campina | 
horríficos | derrubá-lo | guardava | 
pesada | elmo | desusados | desafio | Tribo | 
flor | fabricado | derrogado | desejados | 
falsidade | Constantino | progénie | informara | domado | Progénie | Falsidade | Pedindo | 
ressoando | 
sinais | Sinais | maduros | pesado | retumbava | 
exéquias | 

mole | Mole | Outono | 
ambas | Ambas | Credulidade | bocas | volúvel | miúda | ancas | 
conhece | superfícia | concertava | informava | 
amada | sucede | nojo | Hajam | gastadas | no-lo | Coimbra | 
corrente | rogava | Corrente | 
conheçam | Destruição | encruece | níveo | pesais | miúdo | pecou | 
o | O | Ó | ó | -Ó | Cortaram | especial | cizânias | idáspicos | Havendo-o | 
nome | amado | Faeton | Nome | Ajudada | Amado | trigo | 
levado | destruída | entraremos | embarcar | deslealdade | Ficou-lhe | 
verdadeiras | 
cobiça | ajuntamento | animava | nono | Nono | 
doce | ajudado | galés | moços | eloquência | Ajudado | abrasassem | Doce | Bolonhês | 
destruído | 
mora | Gália | declinada | artifícios | 
correram | cobiço | agardecido | apartava | 
antecessores | amais | correrás | 
Gedrosia | 
Lisboa | dobradas | oculta | tenções | trina | entregar | governar | 
pequenos | pescoço | Treício | 
Regente | Carneiro | ajudais | regente | atalhavam | ovante | amedrontados | milagroso | 
nova | nota | contentamento | Judeia | Nova | undoso | mova | desviam | coubera | 
move | conceito | oculto | note | mesmas | tardanças | correrem | Conceito | notório | pesara | 
outras | Outras | congela | Meliapor | dões | 
férvida | naceste | Patane | 
novo | Noto | Novo | riquezas | tirando | noto | estrangeiro | contenda | virando | severidade | Virando | 
foge | Foge | reparo | varões | sedas | fabricava | contende | ajudá-lo | 
deleitosa | usaram | soberbíssimo | escaparem | cantar-vos | 
movimento | tirania | fervido | rédea | Trarás | férvido | Observam | 
fogo | outrem | onze | Fogo | observar | orbe | senti-lo-á | sucessores | desciam | abondanças | encovados | Deitando-o | Outrem | 
dois | primeira | Ambos | Dois | ambos | Lopes | Arúspices | 
deleitoso | compensando | 
amara | Castelhana | adultérios | convenha | 
cobre | pedes | redes | Remédios | Galos | levará | cegando | 
primeiro | espírito | Primeiro | Espírito | 
pedia | souberam | edificados | Tomando-nos | impetuosos | parecerá | 
Castelhano | Eolo | amaro | afigurada | reposta | segundas | guarde-se | 
perece | deixemos | Destruirá | traria | embaraços | 
verdadeiros | despedia | sentimentos | 
doma | amava | bailos | virginais | chamadas | 
levava | fome | dome | afigurado | limitada | Vulcâneas | Perdão | Levava | 
vontade | Trajano | perdas | 

chamam | dono | agravado | atrevimentos | ciúmes | Ciúmes | Chamam | narizes | Apenino | 
dons | chamar | ficara | mimosa | representando | exercita | limitado | Hércules | enfermo | 
algozes | destina | 
força | fora | Fora | invernos | lasciva | Melodia | folgarás | ameaça | 
tiranos | querendo | Querendo | governou | respiram | 
exército | perder | edifícios | coreias | Inclinai | mimoso | perdes | serdes | 
destino | cometimento | Destino | subiam | perdeu | vapora | Subiam | Ficam-lhe | requeria | Perdeu | 
Inclinam | Andam | perdia | homicida | desvios | andam | ameaço | 
outros | Outros | ficava | andar | Ficava | apressada | Andar | digna | 
Subida | Comori | selváticas | Emódio | escapasse | subida | 
prestante | pareciam | fota | vender-se | 
dote | flutuava | tempestades | sensual | 
sepultura | digno | apressado | Digno | sereis | Sereis | 
subido | pedra | aparência | rúbido | Injuriando | multiplica | mandarei | cortavam | 
cavaleiros | derredor | hão-de | Cavaleiros | pregão | andem | Mensageira | encareçam | mensageira | 
dous | grandura | Dous | pregar | 
Mafamede | tensão | inimicícia | assentada | escapar-te | 
Pedro | fantasia | contenta | toldado | cessavam | inconcesso | 
doze | mensageiro | contente | nobremente | mandaria | Leteia | Contente | Sentindo | 
decreto | aspirava | 
ganha | afrontados | cometê-las | assentado | justiçoso | 
eram | Eram | serena | Gange | marinheiro | adianta | perdoa | segundos | 
juntamente | golpes | Golpes | adiante | Juntamente | Caminham | zebelinos | anéis | 
Obrigados | caindo | igualá-los | janelas | obrigados | 
tiraram | Conduzir-nos | soubesse | chamados | 
sereno | Sereno | partirmos | filomela | 
queremos | alcançando | amoras | Arrepiam-se | Egito | escapavam | 
insânia | incêndios | pedisse | Responde-lhe | 
ignorante | Princesas | Trópico | relatam | assalte | sabeis | princesas | 
guerra | Guerra | afeiçoaram | consinto | 
trombeta | inexpugnábil | chamou | Comete-lhe | merecida | Trombeta | 
fria | fugida | regaço | eriça | Champá | erga | assalto | virgíneas | humor | regam | 
glória | Glória | regas | gloria | 
amores | usavam | Amores | Semicapro | mandas-me | Mandas-me | 
arranca | formada | merecido | Tratar | pediste | começando | travar | 
frio | ameno | paternal | nesses | molesta | repousa | 
aljôfar | andor | 
templo | Afonsos | Pompónio | tapeçaria | Subirá | 
Ouçam | Rege-o | 
repouso | molesto | nuas | Nuas | reger | gamos | estorvando | 
enganados | mandasse | gostosa | encantador | 
muda | ligeiras | regia | régia | Régia | inflamado | Muda | Euristeu | abastecida | 
vestidos | Codro | Iam-se | Cambaica | mude | 
filha | 
súbita | matutina | Saberá | 
tempos | mudo | régio | festejasse | Sabe-se | Samária | 
magoarmos | insanos | Cambaico | formais | 
filho | Filho | quererás | 
súbito | Súbito | aventureira | 
troco | charco | 
dispensa | alevantarmos | 
diamante | caminhos | almadias | Deus-Homem | assentava | 
erra | aventureiro | laço | essa | tomadas | Essa | soldadescas | 
esse | Esse | estremadas | 
corruptores | Compôs | 
jaz | reina | Judita | dezessete | Cíticos | Jaz | 
erro | arreceia | crástina | periga | gritar | consumido | compra | sobejam | Arménia | 
lei | Lei | sobejas | lembrar | 
defesa | 
está | Reino | esta | reino | Esta | Está | erva | Tróia | 
este | Este | perigo | sentiram | sentirão | seios | adereça | brincando | desmedidas | noites | arreceio | Perigo | 
Hespéria | arrenegando | 
Numa | lha | numa | sonorosa | levantado | lia | tranqueira | Lia | sabiam | festejavam | Ei-los | 
lhe | Lhe | louro | magnânimas | Alenquer | sábias | amido | 
divide | Ibéria | 
sabida | Cairão | Choraram-te | engrossa | Hespério | ocupou | caíram | 
Nuno | lho | amiga | louva | tentar | sonoroso | merque | Cônsul | Louva | Pendendo | Tentar | 
converte | esquerda | nuns | Perilo | quentes | Converte | louve | Esculpidas | 
alcançaram | balanços | veremos | Sentado | 
virtude | seita | sabido | Musa | Ligeiros | alcançarás | ferreiro | rábido | Seita | 
amigo | segue | cógnito | Segue | 
duas | Estígio | erguerá | Maumetana | Fuas | Panónios | idóneas | Duas | 
respondendo | insígnias | insolente | inflamava | Hipótades | 
peito | ouro | muro | reformar-te | dArzira | infantes | pedradas | Infantes | Peito | 
contam | Contam | Suaquém | coalhada | 
cometendo | contar | Contas | Cometendo | sabores | 
habitam | enfraqueça | baluartes | achemos | 
Nestas | nestas | peixe | Ouve | Desejando | trono | 
obedece | Ouvi | coalhado | lírios | Idaspe | Dêem-lhe | enfiado | oferecer-se | Obedece | 
contei | 
sejam | diferentes | anima | tomados | Abaxando-lhe | 
pelas | Pelas | Fuge | convém | descuido | fuge | Final | anime | sejas | Naiades | 
sanguina | epitéto | Sapiência | expedição | ditosos | fugi | Coriolano | Bootes | 
finas | encostavam | destranho | dinas | 
divina | ânimo | gritos | Divina | giolhos | defronte | Defronte | nestes | reluzindo | 
pudessem | nautas | sergue | Nautas | concedida | 
mortais | sanguino | Benomotapa | 
coisa | genealogia | fuja | 
potente | divino | 
trazem | concedido | Trazem | Peleu | 
Lua | nomeada | trazer | estreitas | lua | adulação | trazes | emboscaram | aventura | 
divisa | sábios | 
trazia | Trazia | resistir | erguida | Chupando | mudado | sentisse | 
Fortalezas | levantava | fortalezas | 
ventos | duma | nomeado | Ventos | Etna | desterrado | Duma | 
cantando | Tentou | Cantando | Cambalão | esculpidos | ventou | pangaios | 
erguido | perlas | Diogo | triunfantes | quartos | 
luz | Dinis | ventre | gasta | 
fumo | desatina | gaste | pendente | 
delicada | guiada | Ursas | sentiste | 
destruíssem | Cinireia | alcançasse | 
dura | Olhai | arenosa | Dura | ornados | desobedeça | 
marítimas | consócios | Hiperbóreos | 
arneses | Giruna | Comuns | contos | Homeros | 
olhar | contou | Contou | Francisco | lutavam | 
contra | duro | Contra | esquecidos | invencível | Esquecidos | sofredor | Duro | 
universal | colar | ínclitas | habitou | adoração | 
Dione | mestra | alcançar-te | 
mestre | Mestre | preminente | Rodamonte | Assírios | 
pelos | Pelos | Afamadas | mudança | coalhava | particularmente | afamadas | fulgente | 
austeros | amedrenta | 
Quando | quando | boninas | Tormentório | gávea | fabulosas | Dinos | dinos | sacrificando | finos | alongavam | 
discretas | honesta | 
adivinha | 
viciosas | abalar-se | gastando | 
companhia | natura | Natura | Samatra | 
haver | honesto | recolhidos | Tebanos | prende | 
famintos | cometeram | Cometerão | edificando | Cometeram | 
armada | havia | efeito | selva | estreitos | represaria | Efeito | 
miséria | desejaram | 
costumada | 
Ericina | niquícia | fertilíssima | 
armado | Informa | Balduíno | experta | 
coração | Coração | informe | 
costumado | 
Úngaro | Defenderei | arrasta | reluz | 
prémio | experto | conselhos | concerto | escassos | vazante | 
guiara | ardores | aspérrima | alevantastes | 
estatura | Ouviu-lhe | Araspas | 
Portuguesa | Senão | senão | Hipoerene | Formião | mansamente | metade | Mansamente | 
furiosa | encurvado | marítimos | penas | Noruega | 
aspérrimo | prestes | 
olhos | eiras | 
rende | pende | Gonçalo | vingada | 
furioso | colos | Anjos | ínclitos | sentença | anjos | guiava | inexplicáveis | Espedaçam-se | alumiado | Colos | cautelosos | 
pudestes | Uniforme | Mamelucos | 
sendo | direi | Sendo | donzelas | buscais | 
próspera | peões | dessossegado | celebrar | 
míseros | enganá-los | 
fabulosos | 
fábulas | úmidas | render-se | metais | Córdova | 
próspero | subissem | diria | igualavam | 
quanta | cabrestante | viciosos | cantarei | Edificam-se | Quanta | 
iguais | 
salgada | adorava | servidas | Adriática | 
iguala | pernas | metemos | vingais | Iguala | 
quanto | Quanto | acordados | orelhas | iguale | casamento | 
qualidades | covarde | dizendoÓ | Arma-se | 
salgado | Calatrava | Podeis-vos | presume | Converte-se-me | Timavo | 
presente | naqueles | Naqueles | chamando | 
soberba | Mondego | bomba | Conca | espritos | 
cidade | Cidade | desejasse | temerários | custava | presumo | alteração | Pérsico | desejar-se | 
buscara | Pérsias | Belisário | simples | 
rompendo-lhe | 
soberbo | vingança | Henrique | Brâmenes | admiração | destros | alterada | Sândalo | desculpa | Italianos | Vingança | 
costumava | estimam | 
firme | estimar | próprias | 
começa | Começa | morador | mesquinha | admirada | poderiam | 
Conde | aonde | Aonde | remos | descansado | impossíbil | conde | alterado | Etíope | amparo | 
buscava | edificaram | Massília | defendeste | 
prometendo | Prometendo | Descalços | 
idade | animoso | começo | Madeira | comem | madeira | admirado | Idade | desamparos | 
punidos | presas | comer | compadecem | estimem | 
disse | alcança | Disse | adamantino | vindes | coturno | Triunfando | peregrinando | regidos | triunfando | 
Cercadas | crescimento | Aónia | sacode | comia | destrue | 
madeiro | maternal | Tomando-o | 
disso | sentido | Álvaro | Calada | Sentido | 
vestindo | variadas | cintilava | nefanda | 
sente | unidos | verdura | úmidos | Ampaza | Congo | desejavam | 
Oceano | Gasalhado | senti | 
fique | dobrarão | calçado | cajado | 
nefando | verdes | chamamos | Boreal | 
Quereis | silvestres | quereis | cordão | meterem | servidos | 
ninguém | Bóreas | disto | Disto | cantada | Ninguém | cordas | 
perca | amedrontada | altíssonos | 
convidam | 
louvemos | 
cantado | Destemperada | abrasasse | apartar | 
vereis | Vereis | tereis | amedrontado | serão | Serão | 
serás | astúcia | progenitor | espedaçado | Peras | pesar | 
treição | Quimera | Ajuda-o | 
ajudar | Chamam-te | perda | chamam-te | 
perde | edifício | aceitos | conduziu | desatam | Perde | 
totalmente | serei | Totalmente | descobres | queirais | perdi | Serei | enganada | 
próprios | Escandinávia | endoudece | estridor | 
serem | descobria | 
Helicona | seres | 
urdido | 
Cambaia | piedosas | seria | 
ditosa | urgente | Ditosa | daspeito | 
homens | presos | descobrir | Presos | Homens | Descobrir | 
descobriu | quarta | chamarão | reflexo | facunda | 
conta | pressa | Conta | baixos | ínvisíbil | Eclesiástico | 
ditoso | conte | estranhezas | Smirna | austera | 
serras | Teresa | Persas | Mascarenhas | queridas | oferecidas | entendemos | 
facundo | triunfante | quarto | Quarto | variados | delícias | risonha | 
conto | Homero | converteram | sórdidas | comum | 
mísera | tubas | austero | Mísera | 
traslado | chamarem | Parte-se | Origem | edificou | 
risonho | ulmeiro | 
filósofos | 
Sentiu-o | cantara | mísero | 
perna | coral | 
Pérsia | brincava | prometerás | 
vinham | tinham | prudente | Vinham | Tinham | vingam | denodadas | trasladados | 
diante | tomando | letras | Diante | tinhas | vingar | Tomando | 
apartou | queriam | senhoreias | corda | desfizessem | 
tímida | pesos | abastados | tenebrosas | 
descansar | Narsinga | cantava | Cantava | pátrias | tímidos | 
serra | Persa | querida | Divos | ditos | Serpa | 
bordo | suaves | veloces | alifantes | Suaves | Ajudou | ajudou | concavidades | Sacras | 
pátria | cores | Pátria | descansa | Cores | 
Destarte | depressa | teriam | frágoas | entendera | destarte | chovendo | Artabro | 
nobreza | querido | oferecido | cópia | verias | 
Calecu | tingia | Rodrigues | desacordo | entenderam | 
subtil | pátrio | resplandecem | descanso | certifica | 
piedosos | sesta | 
subtis | pessoa | serve | ressurjam | 
partida | insensíbil | enganava | 
certifico | 
perto | satisfaça | ladrão | impedem | descontente | 
carrega | 
partido | Partido | queridos | Pelejai | perros | 
chamar-se | 
sórdidos | negócios | Negócios | 
alteza | evitar | Pelejar | intestinas | pelejas | 
metida | rompentes | 
coroa | tomamos | aspecto | satisfaz | delitos | moderava | crescia | 
setas | houvera | Dizem-lhe | Carpela | dizem-lhe | 
caríssima | 
Sofrendo | paragem | entendiam | 
corno | revolve | corresponde | 
inquieta | assombrado | Coros | coros | 
vinhos | precede | 
endurece | Pintam | Dizei | satisfez | corra | 
corre | Corre | privadas | 
dizem | Dizem | inquieto | descansos | estirpe | pátrios | corri | gramíneo | Tingitânia | 
quatro | dizer | entendido | Tonante | Dizer | fizer | crueldades | Tavila | Fizer | 
corpo | corro | dilatando | esquisitos | fraudulenta | Corpo | brincos | 
dizia | Dizia | 
pressuposto | atravessa | Cilícios | 
costa | corta | humanas | 
corte | ovelha | Sertão | sertão | exercitando | fraudulento | 
sestas | Ideias | 
Cale-se | 
chegam | estranhas | Eritreu | 
chegar | namorar | cheias | fragoso | Chegar | entender-se | vácuo | 
tomaram | desgosto | fiar-se | destinado | 
fontes | numerados | 
coube | Carreta | servem | sesudo | 
pessoas | sequer | barrete | Entretanto | entretanto | 
rodeado | viseira | Rodeado | apertava | trovoadas | 
Antão | genitais | 
Vulcano | covas | flama | nascendo | 
Tomarem | tomarem | violas | 
Africanas | sanguinosa | rociada | ficareis | servil | Enverdecem | 
serviço | rendidas | 
servir | tomaria | pinheiros | 
formosa | Formosa | paraíso | Paraíso | Recolha | eixos | 
Recolhe | recolhe | tingirá | mentirosa | 
antes | Antes | prezas | Chiamai | prezar | magoadas | 
Ismaelita | Anteu | alagoa | eloquentes | Catilina | Despertai | estiver | 
formoso | Germânica | reboliço | Calipsos | 
privados | despertam | bruteza | 
Pintou | cálida | fiavam | 
Sintra | Alcino | nadantes | Suécio | 
Germânico | 
altiva | apercebe | flava | 
murmura | 
humanos | promontórios | 
Moçambique | Criando-a | Satisfação | 
altivo | dignidade | descontentes | dificultoso | servos | 
remando | Inglesas | ter-lhe | ver-lhe | concertadas | 
engenho | estranhos | sestra | sofrerás | comédias | Estranhos | Erimanto | 
Cheios | 
brandura | Nascemos | 
Picam | alague | 
ricas | forçosas | 
pedraria | perfeita | 
Ingleses | exício | sofrerem | maltratada | tomasse | 
cheiro | Cheiro | Eufrates | derribar | Abrindo-o | excessiva | dilataram | 
Alcácere-do-Sal | panelas | 
perfeito | quebra | títulos | 
cousa | arcadas | maltratado | Cousa | 
excessivo | chegue | pexes | arreias | exercitaram | rendidos | 
partidos | tremem | detrimento | desprezei | 
excedem | poderosa | Tremer | enxergar | pisada | 
agrestes | pactos | tremeu | 

regiões | cáspios | saberdes | Cáspios | excedia | famosíssimo | 
poderoso | empório | engrandecido | açouta | 
Açoute | açoute | Receberdes | 
aparecem | forçada | experimentado | despertos | Arcádia | enxerido | 
pertinaz | segurado | despertou | 
Apareceu | desamparados | couto | 
Mahamede | aparecia | 
inimiga | forçado | Inimiga | Forçado | tomavam | esquálida | 
cruíssimo | purpúreas | Servindo | 
impedido | 
Judaico | ensaia | 
inimigo | repugnantes | conhecida | sanguinolento | lácteas | Inimigo | 
Quedas | frondentes | 
Ceilão | Nascerem | 
volteando | vagar | beijar | ensaio | Beijar | 
conhecido | brada | afamaram | vedados | Conhecido | 
Oriental | Quersoneso | ricos | Ricos | forçosos | oriental | confiadas | abraçados | Abraçados | Saxones | 
recado | pecado | experimentá-lo | houvemos | 
apregoa | fuzilando | 
pelejava | brado | arado | rochedo | Arrombam | 
propondo-lhe | amostrais | 
segurança | desprezou | Guarda-lhe | 
Tioneu | memorado | 

marlotas | 
práticas | servidores | sexta | 

cá | mostram | exercitar-se | cüa | Cüa | Soldão | Mostram | Cá | aça | experimentara | 
mostras | mostrar | cortesia | cercando | Áf | crocodilo | Poleás | Mostrar | 
Alemanha | sexto | fartar-se | ah | Sexto | verões | 
braveza | resistirdes | Servimos | 
ao | Ao | co | Co | aço | coroas | aspectos | livremente | 
as | As | às | ar | Ar | pirata | Puseram | Às | Ás | pisava | puseram | Entregando-lhe | 
incautamente | Ausónios | Banquetes | banquetes | impedira | 
Citereia | az | experimentava | 
emparo | ciências | 
momento | quiseram | Fartaque | Purpúreos | desconcerte | aspeito | populosa | Brama | 
abastanças | exercícios | houveram | jaezes | arame | Houveram | convertessem | 
Arábica | 
desconcerto | Bornéu | sucederá | nojosa | Nojosa | 
bramo | despidas | dilatavam | populoso | 
braços | arcos | Arcos | Braços | 
beijos | pudera | Arábico | 
convinha | afronta | adornou | Arábias | carvalho | torvada | Moloso | 
quiseres | confiados | afronte | Exercitavam | 
vai-se | Vai-se | 

torvado | Torvado | guardadora | afamar-se | enobrecidos | 
alumia | jardins | 

brava | vermos | ver-nos | Brava | Informando-se | 
amadores | 
Vai-te | solene | favorecei | enreda | 
rodeiam | afeições | alçando | 
bravo | desbarata | pintada | cravo | favorecem | concílio | rodeias | Desbarata | 

recebe | Recebe | alevantada | perdendo | pudica | rudeza | Curam-no | Ungria | Perdendo | 
mostrou | fazendas | Panopeia | 
pintado | cascavéis | 
cornos | 
alevantado | manifesta | superno | 
Siene | 
desfraldando | vingo-me | 
Favorecei-os | 
pusesse | culpas | sucedido | fôreis | atolados | produzidas | manifesto | referiram | 
certificado | odoríferas | gemas | malvada | 
guardando | inquietas | descendeu | 
apartadas | Sirena | padeçam | domadores | Apartadas | desafiaram | amimados | animados | 
despidos | Austral | quisesse | vulgo | Pirene | Crêem | Pírene | 
honras | malvado | houvesse | Honras | afinem | valem | 
vales | valer | cercaram | ensejo | alvoroçar-se | 
terras | areia | Malabar | pergunta | creia | causaram | ardia | calmas | compradas | Pergunta | Terras | Puseste | armígeros | 
valia | Precedem | redondeza | perclaros | talha | Mafoma | valha | violentos | 
receio | juvenil | 
ardil | aumenta | 
creio | aproveitaram | quiseste | alagada | 
ajunta | Ajunta | rebela | ardis | talho | piramidal | Ardis | 

aumento | desdita | génio | inópia | falava | 
alagado | 
principal | Fazendo-a | 

rodeios | recostado | alembrou-lhe | penates | Bramidos | bramidos | 
da | Da | dá | Dá | Düa | polido | düa | 
de | De | Fé | fé | dê | queima | moravam | ef | fazendo-o | 
Alevanta-se | queime | 
licença | falece | Correm | severo | correm | 
do | em | Do | Em | correr | corres | Vendível | abrandarem | 
és | longas | Correu | Lageia | correu | 
eu | Eu | corria | desejam | trazendo | cadeiras | Trazendo | servir-te | pintava | sedentos | faleçam | 
ardor | desejas | Torcato | Desejar | 
nobre | valor | queira | diversas | alevantava | 
produzidos | 
secretas | odoríferos | Colofónia | ciente | 
desejei | 
Germano | ensinando | princípio | apartados | Estranhamente | Princípio | aproveitar | estranhamente | Repartem-se | 
vulto | claras | aprende | Claras | fizera | competência | 
resplandecente | 
perderão | honrou | 
versos | terror | genro | árdua | Versos | 
breve | Breve | Inculta | demandada | acrescentar | inculta | 
mortífero | retumbando | entendidos | agradece | 
Camboja | 
gente | Gente | árduo | Árduo | 
gasalhoso | 
alarga | difere | Calaiate | 

angélica | apertando | retido | 
corpos | trabalhada | Oritia | 
ondas | guardaras | Ondas | encrespadas | 
Prósperamente | criam | 
angélico | criar | corrre | 
geral | enleada | trabalhado | 
argênteas | enjeitam | geram | 
excelente | memórias | Cananor | diziam | rigor | 

longos | fortíssima | Longos | apouca | maquinava | Glafira | 
bastante | viessem | crido | 
desejos | enganosa | Desejos | 
diversos | Diversos | esquipar | excelsa | fraldas | Desejou | 
fortíssimo | 

ensina | enganoso | 
imóvel | Chamei-me | Antarcticos | 
claros | cristalina | Mediterrano | Brigo | sétima | 

lâminas | Podê-lo-á | vestem | curavam | 
livrado | bastaram | frescura | diabólicos | 
cristalino | Melindana | Cortam | tolheis | Sétimo | 
costas | cortar | Alcides | vestia | festejam | Sabá | 
sabe | Sabe | assenta | perdesse | fementido | 
desventura | chegada | assente | namorada | Séquana | purezas | Chegada | 
Melindano | enobrecem | 

assento | Império | império | arrogante | arremessando | Alarte | bastardo | padrasto | 
chegado | namorado | Chegado | demandava | desbaratada | 
ovelhas | 
debaixo | modos | Debaixo | tributos | Informações | logrando | retrata | 
aventurado | cortiça | 
há | antigamente | ia | desbaratado | Há | Desbaratado | sincera | Argos | Herói | néctar | afirmo | indignada | 
saem | criou | Pado | Tanor | instância | Guardar-se | Canúsio | 
ofícios | retrato | Hermo | geladas | hi | 
ásperas | 
sincero | saia | indignado | gerou | Maratónios | trabalhava | paga | partimos | Vão-se | 
ir | refazer-se | venceriam | tremulavam | is | colhendo | 
pescadores | 
semblante | Mastigam | imotos | rijamente | 
raio | pago | respiravam | doméstica | Memoráveis | Paio | memoráveis | guardaste | 
sair | pais | Turca | Antemão | executado | Antevêem | Sair | 
tanta | veneranda | Tanta | apresentara | antenas | Lácia | apertaram | agasalha | 
escritura | rogando | sala | 
Mombaça | representa | Mirtos | 
mãe | Turco | Tusco | apito | 
tanto | Tanto | venerando | aparelha | Agripina | Obi | 
mal | desesperados | Mal | 
não | Não | gesto | mão | Gerum | man | Mão | 
Mas | mar | nas | mas | Nas | Mar | impossível | preceito | 
nau | mau | aparelho | Nau | guardavam | ladrões | 
Netuno | podendo | Podendo | cortou | 
chegara | feminil | Nabatêos | sofridos | assinalar | Logramos | indinado | horríssono | 
pretende | Vasco | Chega-se | suavidade | escrevam | Tapam | 
ramo | pano | heróica | Concertam-se | condessa | semeava | mel | 
Nem | nem | paços | Mem | Paços | 
tarda | mês | desbaratara | virada | Desbaratará | pretendo | 
Para | para | meu | belicosa | rara | Sara | tarde | Ismael | 
empresa | elmos | amaina-se | Armuza | encobre | desafios | Desafios | Fazem-lhe | pesadas | 
Chegava | quietação | chegava | namorava | 
Flora | altura | Altura | Tiestes | 
mil | raro | Mil | belicoso | raso | escrever | Aqueménia | 
mim | Há-de | há-de | gelados | refrigérios | sonoras | ensinasse | 
ásperos | vária | varia | Mir | desbaratava | 
desgostos | pudibunda | pata | 
gado | afeitos | fabricados | riquíssima | Oja | apressa | desampararam | 
desforço | Polifemos | 
Júpiter | Diz-lhe | diz-lhe | inficionava | brevemente | Crespas | vário | Saul | 
nascimento | Astutas | Asaboro | 
acolher-se | ensinaste | paus | incertas | 
Antenor | Forjou | 
seca | peca | Alexandrina | 
moça | 
pequena | podemos | dalgum | aprendido | Noé | Sofenos | 
real | cresses | tirá-lo | Sinai | jacto | fecunda | 
sinal | seco | nascidos | Sinal | haja | misturada | 
moço | peças | sepulcro | recebendo | Recebendo | Podem-se | 
nos | Nos | nós | pequeno | Nós | mor | Herdaste | incautas | Perfídias | 
seda | fervendo | importuna | estranhíssimo | 
pede | ora | remédio | Ora | sede | noz | parece-o | misturado | Mogor | orça | Galo | parecem | 
irmãos | parecer | resistindo | pedi | Irmãos | 
trovões | pareceu | tirano | requere | desordenados | 
Gama | parecia | tempestade | vasos | Parecia | Demónios | importuno | visíbil | 
insana | rindo | invisível | lavar-se | el-Rei | Pindo | 
tirará | surgimos | confiamos | 
rega | Pega | Anúbis | barretes | pega | 
nua | Barbaria | rege | ouça | Traziam-na | 
insano | 
já | Já | lá | mui | Lá | Mui | la | primor | partir-se | antolhos | lã | partisse | ilustraram | 
noite | seio | desmedida | vagando | pego | 
Reis | num | Num | quente | esculpida | há-se | Malaios | ouço | Ia-se | formas | seis | sonoros | 
nus | apertavam | Pegu | 
pela | Pela | seja | Seja | péla | rogarem | Rodeados | reja | estremado | 
pele | Toledo | poderão | Menónio | arrasa | Arruinar | 
Esculpido | costumai-vos | poderás | Decanis | penedos | Nápoles | delinquentes | 
marítima | radiantes | crespos | transformando | vasto | afortunado | 
pelo | Pelo | inclinando | afamada | andando | pejo | rendera | selo | Andando | 
Tebano | Gate | 
temerária | recebemos | Piróis | serviam | desaparecem | setentrional | 
pena | marítimo | Marítimo | Gambeia | 
afamado | celebra | Tavai | lavavam | Bramindo | pene | Rene | 
célebre | poderes | Factôntea | 
armas | Armas | oitava | temerário | armar | 
Reno | remo | Peno | concertasse | retaguarda | 
Sinon | usurpais | prisca | dormir | lograsse | Monde-o | gibão | 
embarcações | bárbaros | silvestre | servido | Embarcações | Tingindo | incautos | 
será | pera | Pera | Será | flamas | pesa | Oitavo | abastada | 
razões | querem | nomeia | Razões | recreia | moles | pese | Canace | 
queres | querer | prisão | estranheza | Corruptos | corruptos | oferecer | 
arnês | grandíssimos | filósofo | impeças | 
queria | peso | fervente | Vates | negando | Pêro | Informar-te | oferecia | falecesse | Ieda | molhe | Queria | Idea | 
Viriato | 
eternamente | impede | 
seta | apartando | seva | 
sete | pinta | privada | desastres | Sete | petrina | miúdas | 
toldos | arrede | miraculoso | 
companheiros | pelouros | Pelouros | 
acomodadas | pendurados | Salamina | desfizeste | rendida | 
seus | andamos | sinto | privado | deserta | silêncio | Seus | Receberão | receberam | Deserta | 

rica | fronte | conhecem | ilustrasse | sanguinosas | garcenha | engrandeceu | concertavam | 
arreia | rendido | conhecer | conheces | lagosta | 
Apolo | Instrumentos | instrumentos | resistiram | vaticina | prezada | Candace | 
lugar | Harpias | finezas | Cartago | 
rico | forçoso | Sião | renovada | invocados | confiada | sexo | Abraçado | Leucate | 
Cristãos | Hele | arreio | cristãos | poder-se | 
prezado | líquido | pisar | impele | receberes | disformemente | aumentasse | 
exercício | Embarcação | quisera | maldizia | abastança | Quisera | resistirei | nomeou | 
confiado | assela | amadas | declarando | Elvas | 
sucedeu | paredes | aprazíveis | Sucedeu | 
qualquer | Qualquer | 
alabastro | Lianor | odorífera | descende | Eurídice | estremece | Armou | 
geme | violento | perclaro | asselo | 

siga | embaraçado | malefícios | descendo | Descendo | 
secreta | resplendor | Idálios | correntes | apartamos | Hemo | 
menores | Andar-lhe | Determinadamente | 
Anrique | acrescente | Partiu-se | Amansadas | transformaram | Tauro | 
memória | algumas | Algumas | andaram | sigo | Andaram | Máquinas | gera | inclinaram | enjeita | hera | 
contrários | Medeia | Secreto | resgatasse | roubar-lhe | pérfidas | 
socorrer-lhe | Arquetipo | recebê-la | 
formosas | Formosas | tranquila | Canará | Sila | 
tornando | Anafis | Tornando | anafis | 
Daqueles | daqueles | Pétrea | tolher | 
na | Na | má | Nüa | livrar | 
me | Me | confiança | fossem | tolhia | tranquilo | Cancro | Fossem | aldeia | 
mi | áspero | embarcaram | oh | Induzidos | alianças | interpretando | 
bastava | 
no | No | rima | mentirosas | nô | Nô | intitulado | Encrespa | mo | nó | Bárbara | bárbara | 
os | Os | imaginado | Recolheu | Colosso | recolheu | 
ou | Ou | ímpeto | nu | prezara | recebesse | 
desterra | livres | viriam | Martinho | 
bárbaro | Bárbaro | incauto | Tebas | taxar | concorrer | Negarão | 
rios | Rios | assaz | pior | confiavam | Pios | 
engrandece | concorria | recebera | receberá | arpéus | Risos | 
desterro | novidade | pisa | encrespando | envolta | pisou | 
nomes | especiaria | amados | Nomes | embarcaria | amador | Especiaria | padrão | 
velozes | horrendos | risse | imolava | 
Arcturo | tecem | virgem | Executa | Virgem | 
ardentes | riso | Gidá | tecer | siso | facultade | renovava | 
esposas | Pirro | esporas | vagaroso | 
vagarosos | 
Convocados | ressucite | alagoas | prazeres | sobre-humana | Galego | 
Gigante | Arsinário | 
assim | Assim | Tornamos | 
Moniz | vazio | ancorados | Ganhando | embarcava | 
aparelhados | rito | Óbidos | Soltar | Pesa-lhe | soltar | 
perdidos | elemento | teciam | 
avorrecida | matadores | cisternas | 
formosos | Formosos | 
singulares | tecida | 
juízo | Juízo | acrescentando | 
livros | avorrecido | mitiga | lulas | 
Quirino | 

Castela | Galegos | recebida | Sojuga | 
ambição | Canela | brutezas | canela | 
focas | rubicunda | Andaríamos | 
antiga | certamente | amarelos | médico | 
ufano | recebido | falsas | encerrou | 
frotas | imaginava | esmaltam | elemental | adornavam | florescia | Tírios | luminosas | 
mantimento | infinita | medida | repartidos | julga | Julga | descerei | Fúlvia | 
antigo | Gigantes | mágica | grandíloqua | 
galero | Gelanda | promete | 
doces | conduzidos | tornaram | Hidra | Tornarão | coberta | Conduzidos | Debatem | 
infinito | Júlio | despertava | agoureiro | Teotónio | 
grandíloquo | Interpondo | vergonhosas | Certifico-te | prometo | 
monte | andavam | enche | inclinavam | prolongada | privou | Enche | 
blasfema | coberto | Tétios | Siquém | 
Sirtes | Mallomético | escarnecia | Visita | 
Cochim | monto | afirmados | 
destruídos | Destruídos | 
vitórias | avantajado | Solta-me | bovina | 
artificiosa | 
soluços | ondeadas | encoberta | mártires | tornaria | soltos | 
fortes | Fortes | soltou | 
bélica | nítidas | beleza | 
entregado | ofendidos | moram | 
cárcere | 
descobridores | ennobrecido | 
bélico | cruas | fidelidade | amaina | Amaina | compassar | governá-Ia | Trazidos | sã | 
se | Se | pé | morde | 
si | experiências | ri | Medina | Si | 
Ficava-nos | ritos | alvoraçada | 
só | Só | pó | apartavam | 
cruel | mores | soltava | acendem | Apercebem-se | 
apercebia | aquém | 
outeiros | artes | acendeu | falsos | Vede-o | consciências | Ganharam | ganharam | vedem | 
vedes | Vedes | acendia | dobre | suplício | 
Tethys | banhar | imaginando | 
elementos | mercadores | plúmbea | libertador | alferes | imaginações | Elementos | 
murmurar | repetisses | 
Mercadoria | mercadoria | 

vergonhosos | desesperarão | governança | 
ilha | Ilha | refresco | alegra | santidade | sabedores | estocadas | 
alegre | tornasse | potestade | Caterina | Potestade | avisamos | Tornar-se | 
rodeando | castiga | Escolheu | Coulão | 
Cocito | 
undosas | celebrando | deitam | sobe | 
Feitas | fingiam | deitar | 
castigo | engrandecer-se | Governará | Notando | 
soam | Soam | soco | egrégia | Pompeio | 
fingida | 

pensamento | propósito | roda | desviado | Propósito | Undívago | proeminência | 
pode | pôde | Pode | cândida | galgos | Assopra-lhe | Dófar | 
fingido | faltam | 
nossa | feridas | revolvendo | governava | lançam | Nossa | faltar | Revolvendo | entregava | alternando | lumes | 
lanças | morre | Põem | trabalhoso | põem | Morre | 
pões | andassem | apura | morri | 
espada | discorrendo | entendimento | insídias | tecidas | errada | 
nosso | inteira | canina | Nosso | altivos | morro | roga | 
vaidade | tornavam | Cocles | plaga | Defendei | 
insigne | Partimo-nos | 
defendem | morta | enfia | errado | Defendem | Xerxes | 
morte | inteiro | defender | Norte | rogo | exprimentados | Morte | 
Pois | pois | sois | bruta | Hircínia | Adormecer | adormeces | -Pois | Sois | Sóis | Absolutas | 
juízos | Romana | romana | 
enfim | morto | Enfim | pola | Pola | abalizada | camisa | mosto | Morto | 
carneiros | atrevidas | Rutenos | 
bruto | maravilhado | Vencestes | 
Romano | salvamento | Religiosos | Dardânia | penetrando | religiosos | 
Pólo | tamanhas | pólo | redondo | Anibais | sacerdócio | 
arremessa | sublimada | despertando | Alcácere | Despertando | 
sombra | conhecendo | acrescentar-se | pintores | 
Roma | engenhos | desesperar | ganhaste | romã | 
novas | Novas | estrangeiras | Consentem | notas | 
feitos | sublimado | Feitos | carregada | infernal | 
responde | Responde | doença | deitou | 
sono | direita | consentia | pomo | veias | aurífero | Veias | enfreias | alimária | 
Tesifónio | imaginaram | Atada | invejas | Scalabicastro | 
acaba | carregado | soou | 
acabe | rosa | porá | movem | notem | derivada | popa | 
direito | Direito | Ocultos | 
moveu | aventuroso | consentir | 
vã | vá | consentiu | feridos | Vá | movia | acabo | Noutras | daltos | aguardava | 
te | vê | inda | Vê | Te | Inda | derivado | Poro | Parece-lhe | 
ti | vi | sibilante | Vi | lançou | recebimentos | acenando | 
cabeça | esclarece | embarcarmos | Mandinga | 
um | Um | rota | to | tomarmos | noviço | branduras | 
Indo | indo | artilharia | pesares | Abrolhos | pagado | 
tu | junto | Tu | Inês | Babel | Junto | acrescentavam | derribada | Anquises | 
notaram | cabem | trinta | 
povo | Povo | romarias | transunto | roto | certíssima | despendida | espalhas | espalhar | notarás | vivendo | rompido | 
herdeira | comprazer | 
sojugar | recebidas | derribado | 
roxa | aqueixa | Livónios | 
deixam | Deixam | Certíssimo | prosperado | Patanes | atrevidos | 
pintura | deixar | herdeiro | Nereidas | fizessem | Deixas | juram | plebe | Herdeiro | deixas | 
fundas | Marcomanos | Baçaim | 
Roxo | roxo | assoprando | pondes | tamanhos | 
aquelas | Aquelas | cobiçosas | Cuama | 
inabitada | Antípodas | Georgianos | abala | 
penetrante | naufrágio | desfazer | Jordão | botões | 
novos | pedaços | Novos | estrangeiros | Estrangeiros | revolverei | 
notou | jurem | deixes | Cifísia | 
moura | Japão | Dambas | abalo | Moura | 
preço | acendendo | Degradado | degradado | Transtagana | 
aqueles | Aqueles | danada | esmaltado | conchinhas | avara | Noturna | ofenda | 
ofende | 
Mouro | fogem | Amando | Cantigas | doido | 
narração | foges | 
danado | avaro | Imos | imos | imaginar-se | Cezimbra | Noturno | 
Almeidas | noutros | magoam | 
quieta | mágoas | hora | pesasse | lares | Ressuscitassem | pagará | 
atava | 
larga | Lápia | Tomassem | antigas | conheceram | convocando | 
levando | Levando | estandarte | Sustentava | sustentava | 
quieto | deleitosas | Mauritana | giganteia | Giganteia | 
manjares | adversárias | amansando | embebe | 
largo | acaso | rodear-se | danais | Acaso | cavernas | Jactante | Cavernas | 
reparte | sombrios | 
Mauritano | espalhou | perdições | 
castelos | recebidos | clemente | 
proa | cheiros | conformando | Astrolábio | 
rédeas | férvidos | movimentos | aprova | promessa | 
cuidosos | enlevas | 
deixou | Deixou | vejam | estofam | Lusos | superstição | Augustos | Vejam | 
velas | valerosas | graça | maneiras | cumprida | vejas | telas | Invenção | 
ousadia | obediente | banhados | cobiçosos | 
abaxa | 
enveja | enrolavam | abaxe | 
grão | irão | orbes | Cumprido | Irão | cumprido | fogos | 
alegremente | iras | Alegremente | irás | Saídas | 
opressões | âncora | vissem | Dambos | abaxo | 
tiveram | viveram | Tiveram | repartindo | amanse | desonrado | Viverão | 
justa | ateia | Mostrando-lhe | Julgam | 
espera | lassa | velha | julgar | infinitas | Espera | vozReal | amolando | quebram | Mahoma | Julgas | Irei | mantimentos | irei | 
perfeitos | quebrar | espere | 
maldade | reforme | esmaltava | celebravam | empregado | levamos | 
justo | procelosos | pagassem | Alemos | ires | couraça | 
velho | lasso | Velho | espero | 
triste | amante | incitando | Francês | Aparelhamos | Magnos | Triste | 
imbeles | 
antigos | Antigos | ociosa | 
cousas | entrada | dourada | atéli | desparzido | Cousas | Destruindo | Berberia | abranda | 
formosura | deleitosos | abrande | 
rubi | agradecido | Notável | adversários | 
qual | Qual | levanta | injúrias | ousados | ocioso | fizestes | Levanta | 
troféus | feitores | dourado | Quão | Levante | Cádis | arremessões | 
suas | Marrocos | Suas | prometem | ruas | avena | galerno | 
Camenas | Belona | 
ruda | Tritão | Prometeu | excessivos | convenham | prometeu | 
prometia | antígua | Castelhanas | rude | perjúrio | alento | abrange | pude | 
irosos | Ptei | remunerados | 
Emanuel | lavam | contrairo | 
quem | Quem | muitas | rudo | segredos | luzente | Muitas | irmã | amorosas | valerosos | Vê-los | refere | tirsos | grossa | Cumprirá | 
quer | Quer | ofereça | Guadalquibir | preciosas | 
acena | Saturno | Pactolo | 
levaram | Suez | levarão | caravelas | cumpra | arrojando | Cobrem | 
grosso | procissão | Delfim | Conquistado | levarás | 
resposta | ancoraram | ofereço | desenterra | voltas | 
enxerga-se | orava | folha | Cadmo | pertinace | 
sacrifício | alegrai-os | 
quis | Quis | libertando | turbulenta | afeitar-se | ir-se | despertavam | Pereiras | 
acesa | infinitos | 
canora | tomastes | inventa | 
isso | primeiros | tivesse | espíritos | regerdes | Volvem | vivesse | cobrir | volvem | Amasis | 
cobriu | turbulento | enxergava | distinta | 
aceso | Aceso | 
sonhos | Naires | intento | penetra | canoro | Mova-vos | trifauce | 
dinheiro | sonhou | 
acolhendo-se | manceba | 
suma | vence | Vence | pediam | poderosíssimo | Barborá | parecerão | reprovar | órfão | 
Isto | isto | tumulto | tiveste | venci | 
ensífero | 
mancebo | tenção | Magriço | desconfiança | ondeando | Mancebo | 
sumo | vistas | Sumo | queixumes | Vistas | manadas | 
cuida | suor | Cuida | acenavam | Entregai-vos | faltam-lhe | Vede-los | diferenças | Enchem | 
montes | Planeta | venda | tremiam | 
pura | ordem | Entrava | ajudaram | sucesso | entrava | Herculano | tende | 
Castelhanos | pareceres | enchia | cânfora | folgado | Afiguradas | Tartésios | Vicente | 
celeste | deleites | Arsínoe | sibila | Celeste | Orfeu | 
vendo | Vendo | tendo | acham | Tendo | Esbombardeia | laranjeira | amarra | caíam | infando | 
muitos | puro | Muitos | achar | temer | Vistes | vistes | amasse | quilha | Levas-me | cansam | lavor | Achas | vermelhas | infames | Tetuão | Temer | amorosos | 
Albuquerque | cansas | volume | Temeu | filhinhos | latrocínios | 
tenha | venha | temia | infâmia | Tenha | cobertos | Cobertos | elegem | Aleides | 
Acorda | perecem | acorda | 
bandeira | achei | extinto | aquente | Magalhães | Bandeira | 
instructo | 
tenho | Calíope | caído | venho | derradeiras | acabassem | Desembarcamos | Tenho | 
guia | Frandes | assopravam | levasse | acordo | amaste | amar-te | prazenteiros | cruento | aches | 
constantes | felice | Atila | canses | 
visitar | composta | 
consorte | poderosos | resultou | 
Bretanha | fabulando | Permissão | 
fraterno | 
despedida | composto | Dedálea | 
Quíloa | atrevem | Alerta | 
ínsula | humildes | 
Abila | atreveu | intitula | 
governa | amavam | Governa | entrega | Entrega | evitá-los | dobrada | interna | despedido | 
riqueza | Hercúleas | donas | agravadas | 
Estelífero | adultério | Luzem | 
chamada | abrirmos | 
donde | temor | Donde | temos | governo | inverno | vistos | detenha | interno | vemos | Inverno | dobrado | Temor | 
avisa | 
giros | acima | Flegon | tenra | 
chamado | levavam | experimentados | Guardai-vos | 
fomes | bombardadas | afigurados | temperavam | Cirurgião | detenho | Huno | 
ferindo | ancoravam | aviso | amansavam | 
tempo | gritando | tenro | jazem | conformes | gostos | Tempo | aparelhavam | 
tomada | constituições | ajudasse | 
campos | húmidas | achou | 
tenta | 
ornada | antepassados | Ornada | Infante | 
tomado | Assíria | diferente | vontades | celeuma | Tomado | deixassem | chamais | Euxínio | Eborenses | 

vento | tento | Vento | derradeiros | enoja | 
Vénus | leais | ornado | destruir-se | incenso | 
alheias | 

lugares | Lugares | 
casar-se | morada | merecê-los | Oriás | temores | 
donzela | universo | Tomais | Insiste | quinas | 
verão | terão | Verão | caçadores | cujas | Cujas | 
igual | verás | Verás | Terás | buscam | Buscam | escritas | esprito | delira | tomá-la | terás | Igual | alargaram | 
buscar | apercebidos | distinguindo | Buscar | teatro | povoadas | Buscas | 
pelejando | baixa | fortíssimamente | encobertas | Crescendo | cercada | encarniçavam | 
verde | Israel | Verde | 
fomos | verei | terei | donos | tomá-lo | 
dânimo | reduzido | desfeita | tamboril | Cozinheiros | 
cercado | baixo | Cercado | terem | Escarlata | Chamará | verem | ferimos | Terem | afogavam | 
Chama-se | Veres | veres | confronta | cantam | maldição | incitavam | calças | 
Medusa | fingimento | senhoreia | Teseu | Removendo | Cantar | 
verga | teria | veria | morais | 
inimigas | ficaram | Lebre | exercitam | lebre | Ficaram | 
pressuroso | Tingitana | limitados | incendidas | asperíssimo | 
Quinis | torneios | 
humana | respondiam | chamava | Humana | tocados | 
fonte | tomara | crepitantes | saudade | Cantem | Fonte | Cúrcio | 
Africana | africana | Astianás | Abássia | compassado | triunfava | 
interpreta | reinava | bélicas | Preceptos | 
humano | promontório | intrépido | Heitor | Promontório | ficarem | intérprete | destinam | 
perdeis | destinas | 
Africano | Frígios | 
perdê-la | Abassis | esforçados | respondido | sobraçados | 
prontos | purpúrea | Prontos | tomava | Revolvidas | 
alheios | vedado | 
transparente | Calisto | Governador | 
foram | Foram | ter-me | inclinação | 
forças | lascivas | Forças | forçar | 
Arábia | desatinado | adornada | instruído | harmonia | 
defensão | cujos | inclinada | termo | afinando | Cujos | 
fazenda | banhando | ledas | lembranças | provados | 
culpa | Culpa | negada | povoador | Povoador | Apodrecia | apodrecia | soltarão | 
terra | Terra | opinião | calma | Malaca | adornado | Arábio | buscou | cercara | 
ver-se | inclinado | forem | 
fazendo | Fazendo | providência | Providência | alargasse | 
quantidades | produzido | esmeraldas | desembarcavam | 
verso | damizade | lavradores | secretamente | perderá | 
alegramos | calos | 
Refrear | Cantos | refrear | Arquiteto | 
Pomona | Vesta | cantou | 
inimigos | veste | conhecidas | diabólico | linguagem | humílima | Inimigos | Calpe | palmeira | ver-te | Ver-te | sanguinolentos | 
Dóris | exércitos | Quinto | mimosos | quinto | raça | vesti | andais | Exércitos | Andais | Doris | 
ofício | culto | 
pai | sai | Gentios | respirava | Orixa | Sai | 
pregando | sal | prègando | Sal | ficasse | 
são | São | cilada | Clície | Pam | jacente | 
gelado | refrigério | sonora | pelejaram | comprá-la | cresceram | maldizendo | Gelado | rãs | 
pau | sagrada | refreia | incerta | maldita | Maldiva | avisado | 
paz | -Vedes-me | peça | 

Rei | sei | forma | rei | Cumas | sonoro | 
incerto | tálamos | sagrado | incesto | tetas | Crebros | furores | maldito | criastes | dorme | 
sem | Sem | dimproviso | áureas | 
ser | pés | Ser | contrária | comprar-vos | Per | defunto | 
seu | cristal | Seu | conosco | Antártico | Morfeu | perdição | 
Cristão | ria | cristão | lascivos | ameaços | homicidas | 
abastam | fazemos | 
contrário | perdida | pérfida | Turquia | comunicavam | honrassem | 
fosse | ledos | Abraão | Fosse | Canas | 
rio | Cunha | Rio | negara | cascas | Sim | 
banda | esposa | Banda | consumidora | Espora | ásteas | comprara | Encheram-me | 
perdido | pérfido | acode | acidentes | oportuno | ficavam | casada | 
facilmente | saindo | Facilmente | fàcilmente | dignas | apressadas | 
orvalho | Alexandros | 
andava | bando | Andava | inclinava | esmalte | Catuais | incitado | esposo | 
forte | Rainha | Tétis | foste | casado | capuzes | rompas | rainha | Forte | viveis | 
experiência | decente | negava | 
banha | 
conhecidos | Relâmpados | Orientais | mereceram | homicídio | Comorim | acautelada | adjacentes | 
soa | Sob | subidas | 
trabalhos | põe | soe | Trabalhos | Põe | florestas | 
adormece | avisara | Rompem | 
Sol | sol | arrependido | profética | romper | 
som | inveja | cruezas | Cristianíssima | Jalofo | acendidas | 
por | Por | sós | pôr | pôs | cruéis | Sós | ressonantes | adormeçam | abola | Moseos | 
então | sou | Então | alqueires | estudiosos | merecerem | amainou | 
aquela | Aquela | àquela | banhada | prestantes | Decerão | 
aquele | Aquele | etóreo | acentos | Sustentam | Cristianíssimo | 
sustentar | senhorios | sostiveram | sobejaram | Hiacintinas | Sustentar | culpando | 

cobiçoso | garganta | áureos | 
tivera | 
contraste | pecados | 
sua | Sua | fazerem | 
que | Que | estenderam | preciosa | removesse | Acende-se | 
Pereira | fermosas | azagaias | abono | Rui | desonras | 
Sul | mulher | Mulher | montanhas | Entram | 
certeza | barcos | diferença | Vede-lo | entrar | eousas | equóreos | abraços | 
apregoam | sus | admitidos | 
constante | cortesãos | assoprava | abrasa | atreva | 
atreve | humilde | apercebida | bestial | 
povoação | conhecimento | 
campo | Conquanto | 
alheia | invicto | atrevo | 
busca | apercebido | Entres | Cupidos | Ramnúsia | Aretusa | Apercebido | 
canta | incitava | viveza | pelejavam | Pisando | 
Egípcia | brados | humilha | cante | húmido | arados | contemplo | barata | ornam | 
alheio | pedras | subidos | Banhar-me | bradou | sepultaram | 
Busco | ruivas | Areturo | 
canto | Canto | atrás | Atrás | impedimento | viviam | 
Imitando | imitando | merecesse | Egípcio | 
famosas | acendidos | áurea | danosas | Aurea | aposentasse | acendiam | enterramento | corrompida | Gótica | Áurea | 
barba | majestade | casca | abraça | Possuída | Abraça | Majestade | Palmela | possuída | 
deserdado | instituído | 
crueza | claridade | mensageiras | carece | 
traspassado | corrompido | pescarias | áureo | Xados | 
entra | Entra | barão | Espantado | espantado | manando | Capitães | 
entre | vezes | Entre | casas | valentes | Cupido | Atreu | mereceste | casar | Aganipe | 
famosa | acendido | Anfióneas | 
valentia | experimentando | vicia | 
esconde | douro | Douro | Esconde | Entro | entro | 
proeminente | 
famoso | Helena | tornemos | tanques | Danoso | 
vício | fermosos | Barém | descoberta | Sacerdote | sacerdote | abrem | Vício | douta | comovia | Abrem | 
viagem | pontas | Idolatra | escondem | 
exprimenta | combatessem | 
carga | abria | escondeu | Aragão | acabada | entrou | 
descoberto | Leiria | escondia | Relâmpagos | Repelim | douto | Termodonte | 
insistindo | inimicícias | 
piscosa | indiscreta | conceberas | 
jeito | fraca | cargo | liberdade | leito | acabado | Fraca | Ternate | Imagem | 
tormenta | banhavam | abrir | imitava | rutilando | aspirasse | 
abriu | atroa | discórdia | povoara | 
possança | 
fraco | capitaina | capela | contentam | 
contentar | 
atambores | Mostrada | Monstros | monstros | Arómata | ornou | 
imortais | objeto | vulgado | sobejavam | 
murmurando | exalçada | divícias | sossegados | desengana | 
famosos | aquilo | Aquilo | levemente | desengane | íntima | Levemente | libertadores | 
mostrado | vibra | soldado | comprida | mercadorias | 
carne | Ver-me-ás | apagada | via-se | Tibre | 
contentes | esperassem | abominábil | mensageiros | retumba | 
curso | Curso | 
comprido | pimenta | Rómulo | Pimenta | assopros | Títiro | 
casos | caros | malhas | Malhas | Casos | misérrima | 
curta | vícios | custa | saísse | curva | sacerdotes | Curva | Vícios | benefício | 
barra | forçando | Estorva | Ameaçando | ameaçando | 
comovida | Drago | diáfano | imprudente | 
inopinado | 
curvo | tocando | adargas | Moscóvia | curto | praticava | 
carro | Ormuz | alaridos | sopesando | cativarem | 
apresenta | comovido | 
sumptuoso | implacável | Idolátras | Lusitânicas | viagens | apresente | fundamento | cerúlea | 
acabará | Basta | Participante | casta | 
escondera | Capacetes | 
assentados | debuxada | sabedor | ganhar | Pluma | 
caça | coroada | baça | cerúleo | Caça | duvidosa | 
França | apascenta | olhados | injustos | exórdio | marchetada | 
vidas | Cai | cai | Antiguidades | exprimentam | 
ganhei | 
ilhas | duvidoso | Ilhas | incita | cão | Cão | Padecerá | coroado | refrescos | acabava | 
Egipto | mocidade | marchetado | perdoam | suspeitosas | 
marinheiros | Ganges | rutilante | deitada | forjavam | intentado | 
mostrara | mostrará | Mostrara | contentou | Melcíades | Custar-te-emos | 
Mostra-se | Provando | 
bombardeiros | Tifeias | estendessem | 
Tifeu | deitado | Zaire | Povoações | Deitado | tornassem | Emátio | 
bem | Bem | alegres | malina | cem | Cileneu | Alegres | conspira | Sículo | 
ilhéu | descendente | Acude | acude | 
Céu | céu | alegria | agasalhado | Alegria | 
batel | mostrava | superada | Mostrava | despedimento | 
sossego | Acudo | malino | modulando | 
Mavorte | 
Dou-vos | delicadeza | doutos | 
castigar | cio | apanhando | superado | 
doutra | vassalo | escondida | Doutra | 
Apúlia | imortalidades | bívoras | Sabeias | 
ala | sefizeram | seguraria | 
caminhava | Orionte | enamorado | movendo | ale | 
ali | Ali | doutro | escondido | Caríbdis | abrigo | 

amizade | amostrando | Trêmulo | 
Arronches | Engrossando-se | estelante | estrépito | 
ossos | desleal | soada | pudicícia | 
coa | ama | boa | Boa | Coa | ganhou | 
Nalgum | pisaste | constrange | nalgum | conversação | benino | 
refuse | Inventará | 
Sobem | povoamos | sobem | cerimónias | escolhido | 
com | Com | coo | Coo | bom | amo | ano | viera | ervada | Viera | admira | Estoura | 
aos | cor | Aos | cos | Cos | alegrou | Cor | sutileza | relatado | 
fechado | Cicones | 
Filípicos | rigorosas | Ara | ara | sanguessuga | 
estado | dantes | crê | Crê | estouro | incontinente | vidro | 
aljavas | inventava | leões | 
leitos | fracas | possuí-los | cargos | Saiu-se | 
causa | chorosos | acusa | lenha | 
freio | Coelho | piratas | Cranganor | abrirá | abrira | 
cru | 
Ata | 
Até | até | lenho | figura | segurar-se | ate | ave | Batro | 
estais | senhora | Acriso | 
tormentas | 
Cum | avô | castigos | corrompe | cum | cauta | sucedendo | 
Acabe-se | clarifica | 
arvoredo | sulfúreo | Arvoredo | graciosa | aquáticas | atroce | 
consertes | 
cauto | Quero-lhe | pegada | manavam | piráticas | provarão | Estrabo | provaram | regada | 
atroam | honrados | povoaram | cimeiras | freme | 
durara | entregarem | invoca | discórdias | 
noventa | Estrada | influência | 
escala | belígera | Escala | 
ignorantes | Volvendo | venenoso | dexprimentados | Trópicos | 
sobre | Sobre | pobre | invoco | Pobre | 
Troiano | Andaluzia | estrondo | determinados | Tarpeia | 
belígero | abomináveis | 
sitibundo | vítimas | 
Estará | fingidas | término | estraga | 
capitania | dilação | 
guerras | canseiras | corporal | Restaurem | soava | 
branca | inundo | Eternidade | feridade | aprovado | raízes | rigorosos | abatido | imundo | Torne-vos | 
estrago | Hispana | bebem | cecém | agouros | moveram | tratada | resfria | 
opulenta | rutilavam | Opulenta | permaneça | beber | possuindo | cabaias | 
fracos | capelas | bebeu | suspirará | adquirir | Consolação | 
estava | Estava | batalha | branco | Guadiana | lenta | Amostrarão | Batalha | afaga | 
Hispano | tratado | Bramás | hispano | escapa | 
trombetas | sabê-las | merecidas | Navegação | navegação | Helesponto | 
rapinas | branda | Branda | 
lento | ajuntados | 

tormentos | suspirava | lançado | lancem | 
brando | porfia | pensamentos | propósitos | Pensamentos | rodas | proeminências | tocar-te | 
subindo | Subindo | oliveira | situada | 
frias | navegado | encobrindo | 
entregar-se | apanha | governasse | Coulete | 
alevanta | Federico | testemunhas | impedir-se | revestida | 
alevante | poreis | vigor | 
Aquiles | podem | Alférezes | queimar-lhe-á | mostradas | gloriai | 
poder | Poder | podes | Rodes | jamais | afama | 
Aurora | imagina | ocupado | revestido | fermosura | Arábicas | Tigre | Imagina | tigre | 
podia | Ulisses | glórias | Selvagem | Descobridor | descobridor | camilha | povoasse | 
climas | tocavam | navegais | selvages | Pedimos-te | prantado | 

cavalos | Cavalos | instituíram | baxos | 
Carlos | Tágides | 
fingidos | coitados | Fingidos | 
Pudemos | Sucederás | 
Viam-se | 
árvore | descridos | 
reserva | esteio | apanhasse | 
saibamos | reserve | esteis | compete | 
governavam | aquoso | cidreira | entregavam | 
nossas | esteja | recrescem | Recrescem | orfandade | 
quiserdes | Arrancam | 
Fortuna | fortuna | possante | Guimarães | remisso | paternais | merecidos | Remisso | 
entranhas | Vêem-se | Põe-me | Cinosura | acatamentos | Chorou-te | Entranhas | 
tratava | Leonardo | Curral | venustos | Desfez-se | recamadas | 
curioso | vilas | patente | socorrer | munidas | Vilas | socorres | 
globo | Sertório | guarnecida | Morrem | Globo | Produz | conselheira | íntimas | 
mandada | Morrer | morrer | trabalhosos | Cesárea | 

frios | Neptunino | repousar | repousas | esquece | fugidos | 
sofre | guarnecido | afeiçoada | asperezas | podre | Põe-se | Afeiçoada | 
mandado | Lourenço | sofri | 
lustrosa | esqueçam | Césares | docemente | navegava | 
soldados | compridas | 
milagre | puderam | perigosa | Puderam | Milagre | afeiçoado | 
puderas | 
artífice | levemos | 
odioso | Benjamim | 
crédito | perigoso | Crédito | observantes | 
alimpa | Adónis | ergue | 
barões | suspeita | carnes | Barões | fenece | escultura | dureza | 
estrela | espadas | Vedras | puderem | convinham | 
consigo | malícia | esteve | Consigo | 
consentirei | templos | 
convosco | suspeito | experimenta | 
fúrias | divulgado | experimente | 
inchando | doentes | 
Brúsio | imitantes | retumbar | 
nossos | Muluca | rogar | 
verdadeira | Sabendo | 
obrigação | mentiam | Obrigação | fendem | 
Olhando | olhando | pretenderam | 
Levam | levam | negras | 
verdadeiro | levar | sentimento | levas | vitupérios | Libitina | Verdadeiro | 
Rompendo | rompendo | Cursos | cursos | Brasil | Busíris | belacíssimos | 
mandara | Algarves | selvática | vaidades | plagas | Progne | 

caminha | obrigado | Obrigado | 
enseada | bombardas | línguas | demasiado | 
Afonso | selvático | levem | 
Leves | 
caminho | Caminho | guedelha | defendê-lo | 
mandava | Mandava | empecem | memoraram | 
paterno | Estige | 
enfraquecido | espantasse | gostosas | insígnia | 
limites | 
pudesse | fareis | Dareis | Fareis | benignamente | Sarmático | 
fortaleza | Fortaleza | mortal | desemparando | 
especularam | Principalmente | 
Eneias | escrava | estriba | estila | mortas | errados | 
região | torvados | tostados | consentisse | 
sabemos | defenderá | inflamados | mudar | 
concebidos | 
estilo | escravo | regida | Descobri-la-á | adoram | pudeste | Regida | 
humanidade | naquela | vicioso | Igualava | igualava | saíssem | 
Naquele | naquele | 
estima | vinda | mortes | própria | inteiros | 
compadece | estime | cangrejos | 
Latindo | latindo | tiranizado | 
Rompem-se | aparta | Aparta | nadar | atroando | 
próprio | negros | vindo | aparte | batizados | fabricou | chupava | Negros | 
pálida | Pálida | mentira | 
sogro | estorvar | levou | abalroando | mensagem | pariste | 
tinha | vinha | Vinha | Tinha | convenientes | brutas | vaca | letra | 
Tinge | tinge | ensaiados | 
filhas | 
rompente | romance | Marcelo | 
houver | Asianas | vinho | crianças | 
obrigava | acontecera | tornaPosto | incharam | 
carregando-se | imprudentes | 
Romanas | Conciliam | estiva | 
singelo | Cáspia | Tornar-se-lhe | bravas | 
saberás | Súbitas | matutinas | veneração | 
criando | loureiros | 
título | Zéfiro | 
insofríbil | ilustrada | Impossibilidades | 
sumptuosas | Assentarei | defendido | Dizendo-lhe | romperam | 
mortos | notícia | solar | humanamente | beija | vaga | redondas | 
pôr-lhe | 
mostra | Mostra | régios | ilustrado | venerado | Ilustrado | 
ciência | dariam | 
vago | ardendo | saberia | 
tais | Tais | Vimos | detinha | vimos | Hespéridas | Timor | 

viçosa | 
vale | 
Hiperiónio | Cambaicos | descercada | transformado | 
fadigas | Alcmena | 
potência | vejamos | droga | Maluco | espantoso | Eníocos | revocava | 
Austro | Mafra | Cegos | cegos | beiços | Hespérides | 
carros | sólio | Madre | textos | madre | agradeça | desesperação | 
tinta | esquecimento | brutos | Líbia | flautas | Vão-a | maravilhados | Trancoso | Lícia | 
incontinência | fralda | fugir-lhe | escritores | Diverso | diverso | vinte | Incontinência | 
filhos | alguém | Filhos | 
enobrece | demandar | perpétuos | 
tinto | arreceava | núncio | gerados | 
vãos | Bacanor | Filipe | 
nascida | desesperado | 
Ceita | Romanos | vara | escreva | 
bravos | Filipo | pintadas | escreve | Atéaqui | atéaqui | esquiva | Escreve | Bravos | 
tirai | aventureiras | 
nascido | ajuntando | Ajuntando | 
viram | Viram | Virão | vaso | persuade | Demónio | Fernandes | escrevo | virão | disposta | visão | 
tirar | Tirar | esquivo | Virás | trabalhadores | degeneram | 
astuto | sumptuosos | notado | cerúleas | aguardando | pastoral | 
Pólos | dotados | 
lado | disposto | ganhá-la | persuadindo | pastoras | 
primores | pendurado | penetrado | 
disciplina | invocado | industriosas | magas | ilude | perdendo-a | 
ligeireza | Virem | 
alguma | licor | belas | aparelhada | máquina | bastão | acabaram | 
acomodado | Menfítico | cartas | jaezados | 
recebem | concorre | viria | prosseguindo | liara | Viria | insofridas | Tíria | desculpasse | 
ardente | lago | receber | tece | descobrindo | Via-Láctea | Ardente | afogada | aquista | recebes | 
aparelhado | solta | recebeu | Columbo | 
Alguns | alguns | recebia | colunas | Martins | Solte | 
frota | Hebréia | Belém | propuseram | luminosa | Tarquilio | 
Padecendo | padecendo | viris | 
mártire | benditas | fingindo | Fingindo | 
sombras | veda | 
Vede | Adamastor | ganhara | luminoso | criarei | vede | Mostrar-lhe | pastoris | mostrar-lhe | Hebréio | assentavam | 
armaduras | ronca | 
Magis | 
lança | vêem | cativeiro | frecheiro | cingidos | lama | Vêem | arderam | 
defende | exprimentado | Briareu | incógnitas | 
tamanha | ronco | 
enfreia | favorecido | Anibal | auríferas | 
espaço | Jano | Bengala | Magnificência | Cutiale | Lamo | inspirado | pintados | 
laços | cabe | essas | aventureiros | espalha | Laos | Hemispério | Pondá | 
tamanho | Tamanho | províncias | espalhe | Províncias | ponde | Ponde | 
veio | Veio | Inferno | Lara | inferno | cônsona | 
Baco | Cabo | mágoa | cabo | tiros | magoa | mundas | desistindo | 
tirou | Pondo | duvidosas | sombrio | 
maneira | vela | veja | infernais | Veja | vê-la | cobiçadas | 
cada | visse | Fugindo | Cada | fugindo | vir-se | ocasião | maligna | 
notava | esses | Magno | ordenando | descobrimos | diferisse | parceiros | 
maior | Mova-te | instumentos | passassem | Maior | magos | desditosas | 
Tejo | vejo | lava | valeroso | muita | Vê-lo | centro | vê-lo | Argonautas | tê-lo | Centro | velo | tirso | amorosa | segredo | Vejo | longínquos | Lava | Esquecerem-se | 
mostrando | caem | belos | Mostrando | Caem | penetrava | Naira | bafo | 
sonho | cães | Cães | ponho | Naire | marchetadas | apascentar | 
vista | sublimados | carregadas | Dar-lhe | culpado | dar-lhe | Lídia | tema | galardão | respondas | celsa | Vença | infesta | vença | 
muito | Muito | acha | teme | viste | infame | caia | Teme | empecendo | arremessou | recontando | vermelha | Nilóticas | Dálmatas | amoroso | caía | 
acabasse | ache | Jaus | 
ajuntaram | 
visto | temo | cevadas | quatorze | cutiladas | 
tens | nágua | Castro | vermelho | Tens | aparelhava | movidos | vens | Bago | Nágua | 
cair | pronta | Cair | Respondem | inventadas | cais | 
terá | verá | leal | Terá | Verá | caiu | Doenças | provada | inquietação | 
leão | exprimentara | dizQuando | respondeu | vê-se | Ilíricos | 
respondia | Grinaldas | esconder-se | Acertam | trouxessem | 
pronto | emende | vital | Sem-pavor | Ajuntarem | Pronto | 
leda | escrito | defensa | teso | provado | cercam | vivam | Cercam | Titão | 
incógnitos | Cercar | Vivas | calo | vivas | cercar | 
Europa | Temistitão | 
somos | alimárias | pomos | revolvido | criaste | Direitas | prosseguiram | Somos | 
teve | ledo | Agareno | cama | Teve | descobriram | formosíssima | cautamente | 
semelhança | error | pompa | Erros | 
palmas | Rompe | Palmas | rompe | 
vivem | Vivem | inspirava | cuidados | lembrara | gritava | 
teus | viver | montanha | cano | munições | tiver | mundos | Teus | acabavam | 
duvidosos | Caos | Fingiram | Baticalá | Hocém | 
possuía | vivia | 
casa | cara | valente | Casa | alegrava | comprem | 
leis | ponta | Leis | iradamente | abre | Abre | 
estâmago | contrato | males | ponte | 
sossegado | viam | número | audazes | Possam | talento | 
caso | caro | vias | possuir | malha | Caso | espessava | espantar | 
ponto | marchetados | vulgares | possuiu | 
vida | antiguidade | tesouro | afoga | acabar | 
Ptolomeu | Vide | 
padeceu | clemência | fronteira | 
Seguem-no | acharias | honrada | 
leoa | tido | Leoa | 
leme | recompensa | vier | aljava | espantes | 
deitadas | porco | rutilantes | estai | 
rosas | falando | provara | Falando | sustentadas | ajuntar-se | manava | honrado | porás | 
estão | Estão | fugiram | baxa | tardassem | abundosos | 
estas | Espanha | estar | Estas | Reinos | reinos | bebe | ervas | Cabaia | estás | movera | 
determinavam | exaltas | abertos | 
darmas | Sármatas | valerem | 
cavalo | mostraram | vivos | cercos | intrínseco | baxo | Adão | sorrir | 
Porém | porém | apercebessem | porem | 
vila | Direitos | provava | direitos | 
multidão | adereçam | 
perigos | estes | Estes | Perigos | Arménios | 
longamente | socorro | Jesu | milhores | acompanhando | argutos | Socorro | 
leva | mandam | vitupério | Leva | Mandam | Vitupério | consonância | propôs | 
leve | mandar | cedo | mandas | Mandar | mostrarem | Ádem | afeminam | 

adora | Viúva | Afora | afora | viúva | 
cega | Estio | Hespérico | afia | Austrais | Sirenas | 
Portugal | 
ajuntavam | 
nunca | vai | Vai | Nunca | proveito | ordenassem | crédulo | gengivas | 
tal | Tal | cego | val | caminhando | mandes | sopros | merecimentos | 
tão | vão | Tão | Vão | moviam | pousada | desviavam | 
vãs | virá | vira | tira | vás | Virá | Ciclopas | arribando | 
bela | Beja | Lião | acabou | tire | 
Goadiana | Sonorosas | estorninhos | Tranqueiras | Lhas | levantados | espaçosa | Pireneu | 
incógnita | saltando | Saltando | 
cento | louvores | tiro | ambicioso | 
belo | Celo | aéreas | Fugir-me | Indicas | refúgio | Refúgio | 
tem | têm | vem | vêm | Tem | Vem | Têm | Vêm | congelado | movido | Vê-o | Movido | bácaro | 
ver | ter | Vês | vês | viva | cerca | incógnito | Ver | Ter | Viva | 
mundo | Porque | porque | teu | Mundo | vive | Véu | Lieo | Teu | véu | 
via | possa | espanta | vez | lhes | Via | Desistir-se | possui | Possa | procede | louros | retorcendo | Vasques | Reprovando | sopra | seguramente | 
Lieu | estou | tenaces | errante | valerá | provam | posse | salsas | 
cerco | vivo | provar | viu-o | Proteio | provas | soantes | Tito | 
manda | vil | Manda | César | til | 
espanto | mande | posso | vim | bens | caudas | sopro | merecimento | sossegar | 
vir | juntas | Vir | proveja | Juntas | estabelecem | Índica | sibilantes | 
viu | Viu | Londres | cera | dividem | caridade | 
Índia | posta | índia | mando | obediência | porta | mostrasse | mostrar-se | perdoe-me | Posta | Bocejando | sentadas | Mando | 
sorte | nações | Próteo | Nações | Damasceno | 
membros | Índico | dividia | Mando-o | publica | 
manha | portas | manhã | Ceres | Proteu | berço | cepo | destroçada | mandos | portais | 
porto | rosto | posto | Posto | última | descendentes | mandou | ordenaste | Essência | Rosto | essência | maravilhando | 
cabeças | Cabeças | lâmpada | Elísio | 
Pacheco | fruto | público | creias | areias | ceva | Ceva | indómito | Perguntar | procela | Heliogabalo | erguendo | 
uma | pouca | Uma | voa | estrui | Pouca | Voa | sabidas | rouba | destroçado | ceve | 
soube | último | infiel | dividiu | gerando | voe | 
uni | Móbile | lima | 
sortes | Plutão | Condenaram-no | Sorver | oprimir | 
pouco | batéis | céus | Pouco | Céus | agasalhados | vencedora | tom | espalhado | alegrias | Agasalhados | Batéis | acudir | 
vós | vos | Uns | Vós | Vos | uns | Gênero | Indiana | ardido | nestoutra | tos | 
vou | Louvam | Talhas | 
voz | louvar | lhos | amigas | Louvar | usa | Tra | ordenavam | Arzila | caminhante | 
excelência | alvoroça | use | euQuem | acompanharam | válida | 
lira | Lira | preminência | perguntado | lisa | Lisa | 
chão | Malabares | mostravam | castigado | consume | frutas | indícios | bico | aéreos | Ogígia | 
uso | Agar | 
valido | Gentílico | alvoroço | 
benigna | ilustríssima | Fálaris | louvem | 
tua | sojugada | ausência | 
polícia | converteu | assinalados | livrarmos | 
amostra | Lioneses | feroces | Tui | estudo | Bradando-vos | ventando | 
manhas | benigno | inocência | mansa | Acteon | berços | ilustríssimo | creiais | mangas | 
sojugado | cabelo | Rugeiro | 
juntos | cerra | indina | derribadas | Juntos | 
Cesse | 
manso | Alimpamos | ennobrece | arrancaram | 
estupendo | faces | reluzentes | passadores | habitantes | escumando | saltaram | 
sublima | indino | Silveira | 
sublime | escudo | postos | rostos | portos | Sublime | últimas | Zeila | homenagem | Postos | 
Chamando-se | Apolíneo | Rezando | 
África | certa | Africa | caçador | cerva | esforce | Cerva | oferecimentos | 
Cila | fácil | Antepuser | piramidais | 
Musas | manto | sabidos | peitas | ousas | levantai-os | inica | virtudes | Fábio | espalhara | Alencastro | Merencório | 
façais | errasse | 
certo | furtado | 
infidas | cerejas | 
nasce | inico | despovoe | Chamando-te | 
povos | Perimal | pintando | ajuntam | Rotos | perguntara | Pintando | nasci | acompanhar-me | 
cima | Seguem | Castigará | Simulando | 
amigos | louvor | encontra | deixada | Sousa | saltam | Louvor | Marco | roupa | 
obras | salvar | Obras | salvas | obrar | terrena | Guipúscua | dAlentejo | Fervendo-lhe | 
melhor | ribeiras | Melhor | seguia | rebelde | oprimido | contada | 
batiam | públicos | indómitos | 
Actias | deixado | inieo | Centimano | Gnido | encontro | 
terreno | toca | Alcorão | sagitíferas | Firmamento | perguntava | amestramos | 
escuma | musgo | intervalo | 
seguir | fundada | subjugada | imiga | Seguir | 
mares | Mares | Perineu | seguiu | 
azuis | voam | deidade | pressaga | 
infiéis | Maria | roubar | espalhadas | poucas | Infiéis | Ciro | Umas | Voar | escuridade | vencê-la | 
entanto | vassalos | atónito | Faça-se | jurado | doutras | escondidas | 
toda | Toda | Alevantando | alevantando | deixais | condenado | esclarecida | principado | falavam | engrossava | Véspero | 
água | escura | escusa | Escura | apelar | Água | dedicam | Pressago | Régulo | pressago | 
Mário | atalha | insolentes | escuse | trabuco | Taumante | 
passadas | Passadas | 
todo | Todo | finalmente | esclarecido | espingardas | venturas | cetim | 
escuro | Bétis | doutrem | 
atalho | antídoto | 
roxas | talhada | Dizei-mo | salvar-se | furtara | 
principais | tronco | polidas | Dabul | frauta | Apeles | brandindo | Brandindo | 
peitos | muros | Sumano | 
dentes | ousou | acompanhavam | infamados | Ousou | 
segura | subitamente | Subitamente | gemerem | Fartar | hirsuta | 
vencerá | enxuto | Vencerá | Netunina | 
história | prado | Alas | trémulas | tremular | 
linda | desmede | louvada | 
seguro | considerava | 
praia | Tornam | ajuntou | habitais | Netunino | deixara | tornam | deixará | Praia | 
tornar | cuidando | dadas | Tornar | dádivas | esquadrões | marços | venturosas | embandeirada | 
lindo | medonhos | habitá-la | obrou | tentarem | louvado | Lindo | 
manjar | massa | liões | além | Além | 
jejuns | 
toma | Toma | linha | pinturas | tornei | Linha | infantaria | 
Tomé | tome | alevantamos | 
deixava | Maumetanos | arrancavam | tornem | encomendam | 
palavras | tornes | Vigiando | vigiando | saltavam | 
contava | tomo | 
poucos | enfraquece | espalhados | vencedoras | roubos | profunda | anelado | 
Marte | escondidos | acontece | voou | doutros | 
servissem | cachos | 
João | relação | Octaviano | 
profundo | masto | Profundo | Pondera | 
passados | faça | Faça | Acharmos | endurecida | Austrina | aconteças | 
melhores | inumanas | Toro | membrudo | 
vencedores | Dai | Indianas | dai | temerosa | Diomedes | inventando | cativo | Vencida | 
Dentre | combate | Atlântico | propõe-lhe | 
dão | Dão | roxos | eco | 
das | Das | dar | alma | nuvem | Dar | ocidental | Ulcinde | reveses | Aiace | 
vencido | dentro | temeroso | peixes | Dentro | matam | Medicina | aloé | deleitando | medicina | aventajam | 
faz | Faz | matar | Matar | Correia | relevava | 
dar-vos | ouvia | habitava | 
limos | declara | dei | fartou | 
Dafne | sublimaram | Concebe | amizades | trêmulos | 
grande | limpa | vizinha | Grande | alevantaram | traça | Sarracena | Vizinha | correio | 
logo | Logo | jogo | der | dês | Dês | Rendendo-se | obedecem | 
deu | ouvir | prata | sejais | obedecer | Deu | obedeces | Ouvir | abaixa | rinchando | coalhados | 
fez | dia | fados | Fez | fia | dados | ouviu | Fados | obedeceu | Obedeceu | sometido | 
tornou | Sarraceno | Fazendo-se | vizinho | obedecia | fazendo-se | Tornou | 
trás | Sanagá | usar | Trás | Usar | Danúbio | 
abaixo | concede | atando | estelantes | sobrela | abalam | 
traz | fim | Dio | fio | Traz | Comendadores | Fim | Desprezador | 
alta | Eis | eis | ídolos | alva | truculento | Ídolos | apenas | Alta | 
Sancho | engana | perdoar-lhe | concedo | 
ela | diz | desejada | Ela | procuramos | engane | enresta | Diz | 
ele | Ele | bicho | Músicos | despejada | 
alto | três | Três | Alto | validas | 
engano | prazo | miseranda | Engano | 
animal | Crendo | falecem | desejado | crendo | Socotorá | naufrágios | apousentam | indigna | penetrantes | pacífica | Naufrágios | 
boca | Fantásticas | Chale | fantásticas | Chalé | levantando | indigne | 
passagem | Temessem | Madagáscar | Bíbli | descem | faleceu | 
miserando | guerreiras | Hierosólima | Descer | descer | cuidaram | Eoa | Guerreiras | 
outra | Outra | inumanos | desceu | profanos | pacífico | indigno | 
foi | Foi | dói | Deitando | deitando | descia | Amam | lisas | Indianos | 
coas | desconfia | Panane | amar | Começo-lhe | 
chama | Dom | dom | Chama | eoo | triz | Eôo | 
dos | Dos | outro | Outro | for | anda | dor | inclina | Anda | chame | Tarteso | estipulantes | prover-se | desejais | 
ande | descuidos | dou | 
era | Era | vossas | golpe | generosas | foz | matos | descuidadas | desejá-la | 
matou | perpetuamente | jasmins | fugia | 
Maura | ocupa | castigador | refusam | Jove | bicos | 
submetida | cobiçarem | Viemos | Pompílio | viemos | 
receoso | Compunha | 
Loto | 
Mauro | fugir | sanguinas | Tidore | descobir | integridade | Queimou | 
Torres | fugiu | torres | torpes | idónea | 
resista | Portanto | lírio | alevantasse | 
fui | sobejo | Fui | resiste | inventaram | 
pobreza | bois | usou | 
dum | Dum | imensa | Policena | 
companha | ínclita | legislador | chave | Inclita | 
Punham | penachos | punham | 
navegantes | avante | Avante | salteado | Chaúl | 
imenso | frescas | Abaxando | 
Português | colo | Colo | Respondem-lhe | Filáucia | Leoneses | popular | ínclito | 
escolhidos | soados | 
dizendo | Dizendo | corrido | Transtaganas | divinal | Mousés | 
coma | Apousentos | 
presa | come | ânimos | divinas | 
guerreiros | edifica | círculo | pandas | desejava | dilatais | 
convida | Perístera | 
como | Como | descobre | faina | vieram | Vieram | lisos | diligência | Amon | Descobre | ilustríssimas | Tarragonês | 
amor | Amor | anos | Coos | preso | coos | homem | Dai-me | bons | Invejoso | ataram | Bons | Preso | 
tuba | Alemães | inusitado | desalivai-os | avaras | noturnas | alevantavam | 
nobres | queiras | encurva | encurta | abunda | Nobres | contido | 
atentando | dilatá-lo | Dai-mo | preta | temeridade | 
vossos | generosos | conchas | descuidados | Cori | 
peleja | cresce | sabiamente | evidentes | batendo | intestina | 
coro | denodado | troque | derramava | uvas | Tuas | desfaça | 
fundido | ofendem | 
chega | cheia | creram | Chega | indignamente | cresçam | ofender | 
contigo | Esfera | esfera | Apesar | cova | Contigo | servir-vos | levantaram | apesar | pelejo | 
preza | magoada | ante | Ante | variamente | spica | 
florescente | Germânia | radiando | armastes | 
tudo | Tudo | cheio | Cheio | 
dágua | abrindo | Abrindo | despreza | desfaz | deitaram | Dágua | Despreza | 
duvida | dúvida | liberal | sofrimento | Liberal | magoado | 
Mouros | mouros | 
coxa | trovão | cientes | Fizemos | raivosa | 
coisas | Polónios | fujas | Coisas | desprezo | 
duvido | 
desconcertados | contina | 
braço | arco | amostrar | divididos | Iberinas | Braço | 
asas | aras | enteado | 
favorece | convertida | 
contino | ombros | falar-lhe | 
honra | arde | Honra | Divinos | Mecom | potentes | Arde | falam | mudadas | 
vigiavam | confessarem | Falar | falar | 
convertido | releva | enchentes | julgados | favoreças | Certificar-te | desobediência | 
deseja | Deseja | Parténope | faleça | crêm | releve | Xerez | 
ares | Crês | Badajoz | crer | estados | Crer | crês | 
avaros | Zopiro | aprendam | 
cria | Ásia | inerme | Asia | Germanos | 
desejo | viesse | Dalém | Cingapura | Desejo | concedidos | 
Samorim | Cristandade | indústria | moderno | exemplos | Exemplos | choram | ensoberbece | arremeda | 
jocundas | Juba | cabeloÓ | 
cabelos | sojugados | inventavam | Argo | Apio | agasalharam | 
Dá-lhe | dá-lhe | derribando | abrimos | imoto | 
fizeram | Fizeram | rígido | aprendem | 
Monarquia | 
prima | aventurar | aventuras | aprendeu | harpas | antolha | 
crespa | honrosa | 

grandíssima | levantar-se | abaterão | 
pagaram | vitoriosos | lançar-lhe | companheira | 
honroso | horas | radiante | alagando | Iopas | Confessar-me | Prior | fizerem | 
arma | inerte | Nicolau | 
grandíssimo | arme | impeça | magoava | pânico | 
companheiro | pelouro | sustentasse | modesto | ebúrneos | sustentar-se | notifique | 
Cessem | falsamente | resistira | 
necessidade | dalma | Beatriz | cortadora | 
causas | após | amostrou | Causas | Após | causar | gordo | Jápeto | 
aperto | astutamente | arou | 
jugo | livre | traziam | Jugo | Pergunta-lhe | 
Luís | engrandeça | 
assi | Assi | ancorado | matador | portátil | liberta | 
graves | juiz | livro | Lembrando-se | 
falsa | abriram | Combaterá | 
freios | Xeque | socorrer-me | vergonhosa | largam | agradecendo | Agradecendo | 
fugitiva | 
crua | trazido | árduas | choradas | endireita | fulvo | Mahomético | levantavam | 
arte | falso | consciência | feriam | outeiro | levando-a | 
aqui | Aqui | abundantes | religiosa | repousados | molestados | 
fingia | náutica | dhonras | virtuosa | 
falta | trouxe | lume | ferida | Trouxe | chorou | sutilmente | deitavam | Apto | profetizado | 
falte | 
estandartes | religioso | Religioso | 
Juno | Cruz | cruz | virtuoso | Mantuana | náutico | 
passando | noutra | ferido | Dumas | desterrados | Noutra | Pesando-lhe | Ferido | 
consagradas | retorcidos | temamos | Atai | Fingiu | 
maravilhas | funda | Estremadura | jura | Maravilhas | 
sustenha | plácido | 
noutro | Noutro | Avás | 
ingente | China | ousada | Mauritanas | 
Luso | fundo | Augusto | juro | 
agasalhar-te | gorra | agradeceu | Damão | 
damas | medos | famas | danças | toucas | Famas | Agosto | 
injúria | ousado | Ampelusa | injuria | fizeste | Dizer-te | Injúria | 
escudos | Escudos | Fortunadas | 
aves | figuras | derribaram | lenhos | assinalar-se | Reciprocar-se | Aves | 
cercassem | 
atiça | denegrida | cerque | estoutra | 
dando | Dando | reputada | Erguidos | gosta | Mauritânia | 
Manuel | Mareiam | Bintão | Adúltera | derradeira | 
Imperador | façanhas | vencimentos | mantêm | 
estoutro | Estoutro | listrados | Apolíneos | vantavam | Ferina | 
sangue | gosto | senhoras | conforme | Conforme | ruminando | Tocada | obumbrava | amansava | derribarem | sulfúreas | 
derradeiro | largos | Macedónia | caçadora | somenos | adúltero | alagaram | 
gentes | cuja | Cuja | Gentes | gastam | Termópilas | Gastam | Granadil | 
morrendo | Gastar | importa | 
Passamos | peregrinas | Hispálico | Chovem | passamos | tocado | triunfar | pondo-se | 
esforçado | Convoca | Macedónio | 
cujo | certas | Cujo | negaça | ferirá | bestas | próvidas | 
senhores | António | gentil | Gentil | Senhores | 
Gentio | gentio | Gotas | 
gentis | Gentis | afastados | Cuma | 
cume | fatídica | Giraldo | pendentes | Cume | abasta | fumos | Trazendo-nos | Negam | 
somente | argento | Somente | Ponente | salutífera | sòmente | Refocilar | negar | Banharem-se | foi-lhe | 
Catual | hástia | produziu | perguntando | Cinífio | Évora | 
senhorio | sustenta | espessura | Sustenta | deriva | Cleopatra | aconselhara | 
desonra | estendera | profecia | avós | fermosa | sustente | escurecendo | avôs | enlevado | azagaia | 
queixam | salutífero | vingadores | 
cura | Lotaríngia | finjam | aura | 
delicadas | assopra | conforto | novamente | ateada | 
danos | soberanas | damor | diferia | fermoso | Dão-os | bonanças | 
injusta | castigando | desejosas | povoam | liberalidade | 
Capitão | capitão | aconselhava | famélicos | 
imortal | Grécia | 
cerviz | alarido | bigodes | criação | 
injusto | paciente | 
passaram | determinação | Passaram | cheirosa | Desculpado | espalharei | 

Ônfale | 
refrescando | 
cheiroso | atroces | Cheiroso | reverente | arvoredos | 
proas | criado | Amalteia | ajuntada | 
retidos | 
Inglaterra | duras | determinado | arenosas | durar | olhais | 
triunfos | 
quentura | suspiras | rebelado | 
certos | Certos | soando | cervos | 
tocava | aprovam | Espelho | espelho | 
também | Também | promessas | vejais | trezentos | 
esclarecer-se | procura | 
farão | darão | Faraó | molhados | testemunho | Farão | hospitais | 
meios | farás | ódios | 
fúria | ceptro | embaixadores | salvação | 
negra | acompanhada | procuro | Almada | 
regadas | axes | 
geração | darei | farei | 
Tánais | 
negro | acompanhado | batizado | assovia | morreram | darem | Guiador | delicados | Guiados | 
houve | soberanos | Sampaio | 
nascem | Nascem | roubadas | risinhos | desejosos | olhara | obrado | discorre | 
faria | daria | suprema | Daria | Suprema | Faria | Sôbolo | inicos | Axio | 
negue | nasceu | agrada | venenosas | Mavórcios | 
gerado | 
Melinde | Ajunta-me | 
supremo | compelidos | quatrocentos | Bactra | Dário | Dario | 
seguindo | pássaros | Roçalgate | Favónio | Seguindo | Galateia | Fásis | 
Fernando | Márcio | Circes | 
cuidada | fechando | Farpões | 
longínquo | submersa | gozam | passar-se | passasse | 
graças | Ondeam | 
angélicos | Gerais | Salácia | Ajunta-se | 
furor | duros | cuidado | irada | Colcos | enchendo | entrassem | valorosas | Enchendo | pretendiam | arenosos | prosa | Parnaso | 
Nelas | nelas | estragado | 
cinco | Cinco | suspiros | Ser-lhe-á | Ainão | Dividindo | incansábil | 
determinava | pasmava | 
irado | estanças | 
ainda | Ainda | obedientes | ousadias | sagazes | ajuntava | 
trabalhados | instábil | 
prova | soante | 
neles | Neles | Julgando | herança | provê | 
furibundas | penteada | 
vencedor | Estando | Duque | estando | Vencedor | roupas | himeneu | duque | 
Beadala | funéreo | crucificado | dar-se | belígeras | 
abaxar | Cauchichina | sometas | 
esforça | cinge | brevidade | signos | publique | 
passavam | Fernão | ribeira | Medonha | Passavam | medonha | 
gerara | túmida | 
ventura | afábil | sojugando | azul | estruídos | roubador | 
esforço | Cínis | Esforço | estanho | Perseguem-no | 
medonho | galinhas | hospedava | dar-te | ignavo | Buscar-lhe | Ribeiro | revolvessem | 
Daqui | daqui | Música | 
excelentes | múrice | profana | 

altíssimos | Saladino | 
seguiam | menear | 
profano | oprimidos | 
agrava | pobres | Enchem-se | Soares | 
lágrimas | Lágrimas | postura | 
fresca | fatal | propriamente | coalhavam | 
Santarém | comércio | influição | fulgentes | davam | pandeiros | valorosos | Comércio | mudanças | 
depois | Depois | evidente | agravo | inocentes | 

cuidava | fresco | vagabundo | 
vigiava | favoreça | enchente | ligados | estrados | estamos | Troianos | 
agora | Agora | Samori | chora | apetitos | jocunda | maquinavam | chuveiros | 
Mudando | 
matando | quebrada | aplauso | Matando | ramoso | 
grave | firmemente | Nemeio | Larisséia | favoreço | Grave | 
choro | Meneses | jocundo | cioso | favores | Tobias | Mênfis | 
maravilha | Maravilha | encontros | 
David | Tiríntio | grato | Quebrado | 
âncoras | vencimento | cinta | segui-la | orgulho | façanha | graus | beatilha | Salteia | 
áridos | esfria | desembarcar | bastantes | 
estendem | gáveas | Estendem | encheram | encherão | 
estender | desejosa | 
Cinto | julgareis | Estendeu | Némesis | segui-lo | estendeu | tocam | perguntavam | 
suspira | estendia | tocar | 
imundas | julgá-lo | abatidas | 
desejoso | Desejoso | 
enganosas | Circe | 
Sansão | Menão | soasse | Juliana | suspiro | 
vergonha | Sevilha | furibunda | 
aríete | roubado | 
Imploramos | intervalos | Estarão | Provariam | Demodoco | escumas | segui-os | 
términos | vigias | vigiar | Damasco | lanígeros | 
parentes | furibundo | ofensas | irdes | justas | ígneos | Lampécia | 
contudo | Contudo | Cleoneu | 
Grega | Adivinhar | 
favor | cuideis | esperado | telhado | quebrando | favos | 
hóspedes | telhados | sonolento | precipitado | julgares | 
amortecido | imigas | Influirá | 
esperam | difícil | corporais | Grego | julgaria | Esperam | 
esperas | esperar | ireis | velhas | contaminem | seguir-me | 
Duarte | fortíssimos | adquirida | Fortíssimos | desconto | 
justiça | Justiça | 
Miralmomini | ginete | rústicas | Dessas | 
esperais | cheirando | 


 Words: 0


 Unique Words: 10330
